------------------------------------------------------------------------------------------------------------------------
-------|========|-------------------------------------------------------------------------------------------------------
-------|&......Q|---------------------------------------------------------------------|==========|----------------------
-------|.....O../###############################--------------------------------------|..........|----------------------
-------|W.......|------------------------------#--------------------------------------|B.........|----------------------
-------|.K..T...|------------------------------#--------------------------------------|......G.G.|----------------------
-------|.....<..|------------------------------#--------------------------------------|..........|----------------------
-------|===+====|------------------------------#--------------------------------------|....GGO..G|----------------------
-----------########----------------------|=====+===|----------------------------------|....T.....|----------------------
------------------#----------------------|.........|----------------------------------|..F.....T.|----------------------
------------------#----------------------|.......T.|----------------------------------|......B...|----------------------
------------------#----------------------|.........@#################-----------------|..........|----------------------
------------------#----------------------|.........|----------------#-----------------|.B........|----------------------
--------------|===+=====|----------------|.........|----------------#-----------------|..........|----------------------
--------------|.........|----------------|........C|----------------##################+G........B|----------------------
--------------|..CV.T...|----------------|...L.....|----------------------------------|...O......|----------------------
--------------|...C...H.|----------------|......O.E|----------------------------------|......G...|----------------------
--------------|......F..|--|=======|-----|.....D...|----------------------------------|..T......G|----------------------
--------------|.........|--|.......|-----|====_====|----------------------------------|........T.|----------------------
--------------|==+======|--|.A....E|----------#---------------------------------------|...B.>.G.G|----------------------
-----------------#---------|.A.Q...|----------#---------------|============|----------|==========|----------------------
-----------------#---------|.E.....|----------#---------------|....Z.......|--------------------------------------------
-----------------#---------|.......|----------#---------------|............|--------------------------------------------
-----------------##########+.WE....|----------#---------------|.Z..O.......|--------------------------------------------
---------------------------|.......|----------################+.....Z.*Z.Q.|--------------------------------------------
---------------------------|.......|--------------------------|.........V..|--------------------------------------------
---------------------------|.......|--------------------------|...........G|--------------------------------------------
---------------------------|=======|--------------------------|...H...G....|--------------------------------------------
--------------------------------------------------------------|============|--------------------------------------------
------------------------------------------------------------------------------------------------------------------------
