------------------------------------------------------------------------------------------------------------------------
------|======|----------------------------------------------------------------------------------------------------------
------|&.....|----------------------------------------------------------------------------------------------------------
------|......|----------------------------------------------------------------------------------------------------------
------|....../#######################################-------------------------------------------------------------------
------|.O....|--------------------------------------#-------------------------------------------------------------------
------|.<..F.|--------------------------------------#----------------------------|========|-----------------------------
------|..WT..|--------------------------------------#----------------------------|........|-----------------------------
------|......|--------------------------------------#---------------#############+..FT....|-----------------------------
------|====+=|--------------------------------------#---------------#------------|...T.T..|-----------------------------
-----------########-----------------------------|===+===|-----------#------------|B..>OO..|-----------------------------
------------------#-----------------------------|.......|-----------#------------|...GG...|-----------------------------
------------------#-----------------------------|.......|-----------#------------|========|-----------------------------
------------------#-----------------------------|.......+############---------------------------------------------------
-------------|====@==|--------------------------|.OT....|---------------------------------------------------------------
-------------|.......|--------------------------|.S....F|---------------------------------------------------------------
-------------|..TF.O.|--------------------------|C......|---------------------------------------------------------------
-------------|......Z|--------------------------|.......|---------------------------------------------------------------
-------------|......C|--------------------------|.......|---------------------------------------------------------------
-------------|.......|--------------------------|====_==|---------------------------------------------------------------
-------------|=+=====|-------------------------------#----------|========|----------------------------------------------
---------------#-------------|=====|-----------------#----------|.ZHF.GG*|----------------------------------------------
---------------#-------------|..A..|-----------------#----------|..O.....|----------------------------------------------
---------------##############+...FA|-----------------#----------|........|----------------------------------------------
-----------------------------|.F...|-----------------###########+........|----------------------------------------------
-----------------------------|=====|----------------------------|........|----------------------------------------------
----------------------------------------------------------------|========|----------------------------------------------
------------------------------------------------------------------------------------------------------------------------
------------------------------------------------------------------------------------------------------------------------
------------------------------------------------------------------------------------------------------------------------
