------------------------------------------------------------------------------------------------------------------------
-------|=========|------------------------------------------------------------------------------------------------------
-------|&........|------------------------------------------------------------------------------------------------------
-------|..W.O...<|------------------------------------------------------------------------------------------------------
-------|..T....F.|------------------------------------------------------------------------------------------------------
-------|.........+#####################################--------------------------|=========|----------------------------
-------|.........|------------------------------------#--------------------------|..G......|----------------------------
-------|.........|------------------------------------#--------------############+.........|----------------------------
-------|.........|--------------------------------|===+===|----------#-----------|.......O.|----------------------------
-------|=====@===|--------------------------------|.....Z.|----------#-----------|....O....|----------------------------
-------------##########---------------------------|.......|----------#-----------|.......T.|----------------------------
----------------------#---------------------------|.O.....|----------#-----------|...F..G.B|----------------------------
----------------------#---------------------------|.FS....|----------#-----------|.TT....T.|----------------------------
----------------------#---------------------------|.....T.@###########-----------|.........|----------------------------
----------------------#---------------------------|.......|----------------------|..>......|----------------------------
--------------|=======+=|-------------------------|.......|----------------------|=========|----------------------------
--------------|.........|-------------------------|===+===|-------------------------------------------------------------
--------------|.CH......|-----------------------------#-----------------------------------------------------------------
--------------|.....O...|-----------------------------#-----------------------------------------------------------------
--------------|..F......|-----------------------------#-----------------------------------------------------------------
--------------|.....T...|-----------------------------#-----------------------------------------------------------------
--------------|........Z|--|=======|------------------#-----------------------------------------------------------------
--------------|==+======|--|....F.*|------------------#---|====|--------------------------------------------------------
-----------------##########+DF..S..|------------------#---|..G.|--------------------------------------------------------
---------------------------|.......|------------------#---|...Z|--------------------------------------------------------
---------------------------|=======|------------------#---|C.O.|--------------------------------------------------------
------------------------------------------------------####+....|--------------------------------------------------------
----------------------------------------------------------|.G..|--------------------------------------------------------
----------------------------------------------------------|====|--------------------------------------------------------
------------------------------------------------------------------------------------------------------------------------
