------------------------------------------------------------------------------------------------------------------------
------------------------------------------------------------------------------------------------------------------------
--------------------------|=========|-----------------------------------------------------------------------------------
--------------------------|.........|-----------------------------------------------------------------------------------
--------------------------|..W......|------------|================|-----------------------------------------------------
--------------------------|....Z....|------------|....G...........|-----------------------------------------------------
------####################+......T..|------------|...........O....|-----------------------------------------------------
------#-------------------|........./############+...G............+##################-----------------------------------
------#-------------------|.L......E|------------|....C...........|-----------------#-----------------------------------
------#-------------------|.........|------------|....Z...........|-----------------#-----------------------------------
------#-------------------|.......O.|------------|........E.......|-------------|===+======|----------------------------
------#-------------------|.........|------------|................|-------------|........G.|----------------------------
--|===_====|--------------|.........|------------|................|-------------|.T........|----------------------------
--|........|--------------|.........|------------|............C.Z.|-------------|.....B....|----------------------------
--|........|--------------|=========|------------|...............H|-------------|G...B..G..|----------------------------
--|....T.N.|-------------------------------------|.*..............|-------------|...U...O..|----------------------------
--|......O.|-------------------------------------|================|-------------|.G.....O..|----------------------------
--|........|--------------------------------------------------------------------|..T....TT.|----------------------------
--|Q.......|--------------------------------------------------------------------|...E....>.|----------------------------
--|D<......|----------------------------|=========|-----------------------------|==========|----------------------------
--|===+====|---------|======|-----------|A........|---------------------------------------------------------------------
------#--------------|......|-----------|.........|---------------------------------------------------------------------
------#--------------|......|-----------|......FFW|---------------------------------------------------------------------
------###############+.UT...+###########+.........|---------------------------------------------------------------------
---------------------|..C.O.|-----------|..QQ.....|---------------------------------------------------------------------
---------------------|Z...H.|-----------|.....D...|---------------------------------------------------------------------
---------------------|..E...|-----------|=========|---------------------------------------------------------------------
---------------------|======|-------------------------------------------------------------------------------------------
------------------------------------------------------------------------------------------------------------------------
------------------------------------------------------------------------------------------------------------------------
