------------------------------------------------------------------------------------------------------------------------
-----------|========|---------------------------------------------------------------------------------------------------
-----------|........|---------------------------------------------------------------------------------------------------
-----------|.<....../#########################################----------------------------------------------------------
-----------|........|----------------------------------------#----------------------------------------------------------
-----------|........|----------------------------------------#----------------------------------------------------------
-----------|====+===|----------------------------------------#----------------------------------------------------------
----------------#----------------------------------------|===+====|-----------------------------------------------------
----------------#----------------------------------------|........|-----------------------------------------------------
----------------#----------------------------------------|........|---------------------------|========|----------------
----------------######-----------------------------------|........+######################-----|........|----------------
---------------------#-----------------------------------|........|---------------------######+...O....|----------------
---------------------#-----------------------------------|=====+==|---------------------------|........|----------------
-----------------|===+====|------------------------------------#------------------------------|.....F..|----------------
-----------------|........|------------------------------------#------------------------------|........|----------------
-----------------|........|------------------------------------########-----------------------|........|----------------
-----------------|..O.....|-------------------------------------------#-----------------------|.....>..|----------------
-----------------|........|-------------------------------------------#-----------------------|========|----------------
-----------------|======_=|-------------------------------------------#-------------------------------------------------
------------------------#------------------------------------------|==+=====|-------------------------------------------
------------------------#------------------------------------------|........|-------------------------------------------
------------------------################---------------------------|........|-------------------------------------------
---------------------------------------#---------------------------|....O...|-------------------------------------------
-----------------------------------|===+====|----------------------|........|-------------------------------------------
-----------------------------------|........|----------------------|========|-------------------------------------------
-----------------------------------|.....O..|---------------------------------------------------------------------------
-----------------------------------|........|---------------------------------------------------------------------------
-----------------------------------|........|---------------------------------------------------------------------------
-----------------------------------|========|---------------------------------------------------------------------------
------------------------------------------------------------------------------------------------------------------------
