------------------------------------------------------------------------------------------------------------------------
------------------------------------------------------------------------------------------------------------------------
-------|=========|------------------------------------------------------------------------------------------------------
-------|.........|------------------------------------------------------------------------------------------------------
-------|..MT<....|------------------------------------------------------------------------------------------------------
-------|..O......+##################################--------------------------------------------------------------------
-------|.........|---------------------------------#--------------------------------------------------------------------
-------|.........|---------------------------------#--------------------------------------------------------------------
-------|F........|---------------------------------#--------------------------------------------------------------------
-------|=====+===|---------------------------------#--------------------------------------|======|----------------------
-------------#####-------------------------|=======+===|----------------------------------|......|----------------------
-----------------#-------------------------|S..........|----------------------------------|.....>|----------------------
------------|====+=|-----------------------|...........|----------------##################+......|----------------------
------------|......|-----------------------|..H.....T..|----------------#-----------------|......|----------------------
------------|...O..|-----------------------|...........+#################-----------------|..F...|----------------------
------------|...T..|-----------------------|...........|----------------------------------|G.....|----------------------
------------|Z.....|-----------------------|...........|----------------------------------|..T.O.|----------------------
------------|F..H..|-----------------------|........O..|----------------------------------|......|----------------------
------------|==+===|-----------------------|..F........|----------------------------------|......|----------------------
---------------#---------------------------|...........|----------------------------------|..*.B.|----------------------
---------------#---------------------------|========_==|----------------------------------|......|----------------------
---------------#------------------------------------#-------------------------------------|.O.T..|----------------------
---------------#-----------|========|---------------#----|=====|--------------------------|......|----------------------
---------------#-----------|........|---------------#----|...Z.|--------------------------|======|----------------------
---------------#-----------|........|---------------#####+GF.G.|--------------------------------------------------------
---------------############+.F......|--------------------|.....|--------------------------------------------------------
---------------------------|S.F.M...|--------------------|...C.|--------------------------------------------------------
---------------------------|========|--------------------|.....|--------------------------------------------------------
---------------------------------------------------------|=====|--------------------------------------------------------
------------------------------------------------------------------------------------------------------------------------
