------------------------------------------------------------------------------------------------------------------------
------------------------------------------------------------------------------------------------------------------------
-----|=========|--------------------------------------------------------------------------------------------------------
-----|&........|--------------------------------------------------------------------------------------------------------
-----|<........+########################################----------------------------------------------------------------
-----|.........|---------------------------------------#----------------------------------------------------------------
-----|.........|---------------------------------------#----------------------------------------------------------------
-----|....T....|---------------------------------------#----------------------------------------------------------------
-----|.OF......|-------------------------------|=======+=|--------------------------------------------------------------
-----|....S....|-------------------------------|..F......|--------------------------------------------------------------
-----|=====@===|-------------------------------|H.....S..|--------------------------------|==========|------------------
-----------####--------------------------------|.........@################----------------|.......G..|------------------
--------------#--------------------------------|......O..|---------------#----------------|.....BT...|------------------
-----------|==+====|---------------------------|.........|---------------#----------------|......T...|------------------
-----------|....H*.|---------------------------|.........|---------------#----------------|....O...>.|------------------
-----------|Z......|---------------------------|.......T.|---------------#----------------|..........|------------------
-----------|.......|---------------------------|.........|---------------#----------------|.......T..|------------------
-----------|Z....T.|---------------------------|====+====|---------------#----------------|.....O....|------------------
-----------|...O...|--------------------------------#--------------------#----------------|..........|------------------
-----------|..F....|--------------------------------#--------------------#################+..T.......|------------------
-----------|.......|--------------------------------#-------------------------------------|.G.......F|------------------
-----------|=====+=|----------|======|--------------#------|=======|----------------------|..........|------------------
-----------------#------------|......|--------------#------|..Z.HGG|----------------------|..........|------------------
-----------------#############+....F.|--------------#------|...O...|----------------------|==========|------------------
------------------------------|..DD..|--------------#######+...F...|----------------------------------------------------
------------------------------|======|---------------------|.......|----------------------------------------------------
-----------------------------------------------------------|=======|----------------------------------------------------
------------------------------------------------------------------------------------------------------------------------
------------------------------------------------------------------------------------------------------------------------
------------------------------------------------------------------------------------------------------------------------
