------------------------------------------------------------------------------------------------------------------------
---------------------------------------------------------------------|==========|---------------------------------------
---------------------------------------------------------------------|...G......|---------------------------------------
---------------------------------------------------------------------|...V.H....|---------------------------------------
---------------------------------------|=======|---------------------|ZO........+#####----------------------------------
---------------------------------------|&....Z.|---------------------|..C.F.....|----#----------------------------------
---------------------------------------|.......|---------------------|....H..H..|----#----------------------------------
---------------------------------------|.K.....|---------------------|========+=|----#----|========|--------------------
---------------------------------------|...OT.H|------------------------------#------#----|........|--------------------
---------------------------------------|...H...|------------------------------#------#----|.....B..|--------------------
---------------------------------------|=+=====|------------------------------#------#----|........|--------------------
-----------------------------------------#------------------------------------#------#----|....GB..|--------------------
-----------------------------------------#------------------------------------#------#----|.O......|--------------------
-----------------------------------------#------------------------------------#------#----|........|--------------------
-----------------------------------------#-----------------------|=====|------#------#----|........|--------------------
-----------------------------------------#-----------------------|.....|------#------#----|..TT....|--------------------
-----------------------------------------########################/..<D./#######------#----|.>..TG..|--------------------
--------|========|-----------------------------------------------|...V.|-------------#----|.O......|--------------------
--------|........|-----------------------------------------------|.....|-------------#----|........|--------------------
--------|...H....|-----------------------------------------------|..O..|-------------#####+.T.....G|--------------------
--------|........|---------------------|=========|---------------|.T.F.|------------------|....GU..|--------------------
--------|.TK.....+###########----------|........W|---------------|.....|------------------|.G..F...|--------------------
--------|........|----------#----------|F.....FQ.|---------------|=@===|------------------|........|--------------------
--------|...W....|----------#----------|.........|-----------------#----------------------|========|--------------------
--------|.....*..|----------#----------|.D.......|-----------------#----------------------------------------------------
--------|......F.|----------#----------|..A......+##################----------------------------------------------------
--------|========|----------###########/.......V.|----------------------------------------------------------------------
---------------------------------------|..E......|----------------------------------------------------------------------
---------------------------------------|=========|----------------------------------------------------------------------
------------------------------------------------------------------------------------------------------------------------
