------------------------------------------------------------------------------------------------------------------------
------------------------------------------------------------------------------------------------------------------------
-------|=====|----------------------------------------------------------------------------------------------------------
-------|.....|----------------------------------------------------------------------------------------------------------
-------|.....|----------------------------------------------------------------------------------------------------------
-------|...X.|----------------------------------------------------------------------------------------------------------
-------|..F..+#############################################-------------------------------------------------------------
-------|D..T.|--------------------------------------------#-------------------------------------------------------------
-------|.....|--------------------------------------------#------------------------|=======|----------------------------
-------|.....|-----------------------------------|========+==|---------------------|.......|----------------------------
-------|=+===|-----------------------------------|.........F.|---------------------|.......|----------------------------
---------##########------------------------------|........O..+###########----------|BO.....|----------------------------
---------------|==+==|---------------------------|...........|----------###########+..FG.T.|----------------------------
---------------|.....|---------------------------|...........|---------------------|>...TO.|----------------------------
---------------|.....|---------------------------|.....D.....|---------------------|.......|----------------------------
---------------|*....|---------------------------|...........|---------------------|.......|----------------------------
---------------|.O...|---------------------------|........T..|---------------------|=======|----------------------------
---------------|.T...|---------------------------|..C........|----------------------------------------------------------
---------------|Z.H..|---------------------------|===+=======|----------------------------------------------------------
---------------|.C..F|-------------------------------#------------------------------------------------------------------
---------------|===+=|-------------------------------#------------------------------------------------------------------
-------------------#----------|=======|--------------#---------|=========|----------------------------------------------
-------------------#----------|....DF.|--------------#---------|G........|----------------------------------------------
-------------------###########+.......|--------------#---------|......F..|----------------------------------------------
------------------------------|..FD...|--------------##########+..HO.Z...|----------------------------------------------
------------------------------|=======|------------------------|.G.......|----------------------------------------------
---------------------------------------------------------------|=========|----------------------------------------------
------------------------------------------------------------------------------------------------------------------------
------------------------------------------------------------------------------------------------------------------------
------------------------------------------------------------------------------------------------------------------------
