------------------------------------------------------------------------------------------------------------------------
-----|======|-----------------------------------------------------------------------------------------------------------
-----|&.....|-----------------------------------------------------------------------------------------------------------
-----|....../##############################################-------------------------------------------------------------
-----|.FT.O.|---------------------------------------------#-------------------------------------------------------------
-----|......|---------------------------------------------#------------------------------|==========|-------------------
-----|<..D..|---------------------------------------------#------------------------------|......G...|-------------------
-----|===+==|---------------------------------------------#----------------##############+....T....B|-------------------
---------#########--------------------------------|=======+==|-------------#-------------|..T.O.T>..|-------------------
-----------------#--------------------------------|..........|-------------#-------------|G...O..T..|-------------------
-----------------#--------------------------------|.....M....|-------------#-------------|..........|-------------------
-----------------#--------------------------------|..O.......|-------------#-------------|==========|-------------------
-----------------#--------------------------------|..........|-------------#--------------------------------------------
-----------------#--------------------------------|..........|-------------#--------------------------------------------
-----------|=====+===|----------------------------|......C...@##############--------------------------------------------
-----------|.....F...|----------------------------|..........|----------------------------------------------------------
-----------|.......*.|----------------------------|..F.....T.|----------------------------------------------------------
-----------|.........|----------------------------|..........|----------------------------------------------------------
-----------|C.HO..T..|----------------------------|===_======|----------------------------------------------------------
-----------|..C......|--------------------------------#-----------------------------------------------------------------
-----------|=+=======|--------------------------------#-----------------------------------------------------------------
-------------#----------------------------------------#-----------------------------------------------------------------
-------------#----------------|=========|-------------#----|========|---------------------------------------------------
-------------#----------------|........F|-------------#----|.......Z|---------------------------------------------------
-------------#################+......D..|-------------#####+...O....|---------------------------------------------------
------------------------------|.S.......|------------------|...G....|---------------------------------------------------
------------------------------|.F.......|------------------|...C..G.|---------------------------------------------------
------------------------------|=========|------------------|........|---------------------------------------------------
-----------------------------------------------------------|========|---------------------------------------------------
------------------------------------------------------------------------------------------------------------------------
