------------------------------------------------------------------------------------------------------------------------
------------------------------------------------------------------------------------------------------------------------
------|=========|-------------------------------------------------------------------------------------------------------
------|&........|-------------------------------------------------------------------------------------------------------
------|.O.......+#############################--------------------------------------------------------------------------
------|......T..|----------------------------#--------------------------------------------------------------------------
------|F........|----------------------------#--------------------------------------------------------------------------
------|D...X....|----------------------------#------------------------------------|======|------------------------------
------|=======@=|-------------------------|==+====|-------------------------------|......|------------------------------
--------------#########-------------------|.......|---------------################+...TT.|------------------------------
----------------------#-------------------|F......|---------------#---------------|...O..|------------------------------
----------------------#-------------------|.......+################---------------|G.T.F>|------------------------------
---------------|======+==|----------------|...A..C|-------------------------------|.....B|------------------------------
---------------|.........|----------------|..O....|-------------------------------|======|------------------------------
---------------|.....H...|----------------|.......|---------------------------------------------------------------------
---------------|.........|----------------|=====+=|---------------------------------------------------------------------
---------------|..H......|----------------------#-----------------------------------------------------------------------
---------------|.C.F.*...|----------------------#-----------------------------------------------------------------------
---------------|===+=====|----------------------#-----------------------------------------------------------------------
-------------------#----------------------------#-----------------------------------------------------------------------
-------------------#----------------------------#-----------------------------------------------------------------------
-------------------#----------------------------#-----------------------------------------------------------------------
-------------------#------------|=========|-----#-----------------------------------------------------------------------
-------------------#------------|...A.....|-----#--------------|======|-------------------------------------------------
-------------------#------------|.......F.|-----#--------------|.FZ...|-------------------------------------------------
-------------------#############+.........|-----#--------------|.Z....|-------------------------------------------------
--------------------------------|.....A...|-----###############+...O..|-------------------------------------------------
--------------------------------|=========|--------------------|..G..G|-------------------------------------------------
---------------------------------------------------------------|======|-------------------------------------------------
------------------------------------------------------------------------------------------------------------------------
