------------------------------------------------------------------------------------------------------------------------
------------------------------------------------------------------------------------------------------------------------
------------------------------------------------------------------------------------------------------------------------
------------------------------------------------------------------------------------------------------------------------
-------------------------|===========|----------------------------------------------------------------------------------
-------------------------|...........|----------|===============|-------------------------------------------------------
-----------##############+...........|----------|...............|-------------------------------------------------------
-----------#-------------|...O.......|----------|...............|-------------------------------------------------------
-----------#-------------|...........+##########+...............+###############################------------------------
-----------#-------------|...........|----------|...............|------------------------------#------------------------
-----------#-------------|...........|----------|...............|-------------------------|====+========|---------------
-----------#-------------|.........^.|----------|...............|-------------------------|.............|---------------
-----|=====+=|-----------|...........|----------|...............|-------------------------|..^..........|---------------
-----|&......|-----------|...........|----------|...............|-------------------------|..........^..|---------------
-----|.......|-----------|===========|----------|............O..|-------------------------|...........O.|---------------
-----|....<..|----------------------------------|...............|-------------------------|.....T.......|---------------
-----|...O...|----------------------------------|===============|-------------------------|....T....>...|---------------
-----|.....T.|----------------------------------------------------------------------------|.............|---------------
-----|.......|----------------------------------------------------------------------------|=============|---------------
-----|==@====|-----------------------------|=================|----------------------------------------------------------
--------#----------------|======|----------|D.......S........|----------------------------------------------------------
--------#----------------|..QH..|----------|.....E...Q.......|----------------------------------------------------------
--------#----------------|...U..+##########+..............U..|----------------------------------------------------------
--------#----------------|...ZT.|----------|..............F..|----------------------------------------------------------
--------#################+.O....|----------|............A....|----------------------------------------------------------
-------------------------|......|----------|........Q........|----------------------------------------------------------
-------------------------|......|----------|=================|----------------------------------------------------------
-------------------------|======|---------------------------------------------------------------------------------------
------------------------------------------------------------------------------------------------------------------------
------------------------------------------------------------------------------------------------------------------------
