------------------------------------------------------------------------------------------------------------------------
------------------------------------------------------------------------------------------------------------------------
------------------------------------------------------------------------------------------------------------------------
------------------------------------------------------------------------------------------------------------------------
------------------------------------------------------------------------------------------------------------------------
-------------------------|===========|------------|===================|-------------------------------------------------
-------------------------|...C.......|------------|.......G...........|-------------------------------------------------
----------###############+........V..|------------|...................+####################-----------------------------
----------#--------------|...........|------------|....C..............|-------------------#-----------------------------
----------#--------------|...........|------------|...................|-------------------#-----------------------------
----------#--------------|...S.......+############+...CO..............|---------------|===+======|----------------------
----------#--------------|...........|------------|............Z......|---------------|...G......|----------------------
-----|====_===|----------|..........*|------------|.....GC.........Q..|---------------|.......B..|----------------------
-----|.......D|----------|.......O...|------------|...................|---------------|..T.......|----------------------
-----|....Q.O.|----------|........T..|------------|..............K....|---------------|G...UO....|----------------------
-----|...T....|----------|......F....|------------|.......Z...........|---------------|..G.......|----------------------
-----|......V.|----------|===========|------------|===================|---------------|......>...|----------------------
-----|......<.|-----------------------------------------------------------------------|.B.O......|----------------------
-----|===+====|-----------------------------------------------------------------------|......G...|----------------------
---------#-----------------------------------|=========|------------------------------|.F..G.T...|----------------------
---------#------------|======|---------------|..F.....F|------------------------------|...T......|----------------------
---------#------------|..Z...|---------------|.........|------------------------------|..........|----------------------
---------#------------|......|---------------|....S....|------------------------------|==========|----------------------
---------#------------|......|---------------|.........|----------------------------------------------------------------
---------#------------|...H..+###############+E.....D..|----------------------------------------------------------------
---------#------------|......|---------------|.....F...|----------------------------------------------------------------
---------#############+..TOVC|---------------|......S..|----------------------------------------------------------------
----------------------|..Q...|---------------|=========|----------------------------------------------------------------
----------------------|======|------------------------------------------------------------------------------------------
------------------------------------------------------------------------------------------------------------------------
