------------------------------------------------------------------------------------------------------------------------
------------------------------------------------------------------------------------------------------------------------
------|======|----------------------------------------------------------------------------------------------------------
------|&.....|----------------------------------------------------------------------------------------------------------
------|....F.|----------------------------------------------------------------------------------------------------------
------|......+###################################-----------------------------------------------------------------------
------|..O.<.|----------------------------------#-----------------------------------------------------------------------
------|....A.|----------------------------------#-----------------------------------------------------------------------
------|......|----------------------------------#-----------------------------------------------------------------------
------|====@=|--------------------------|=======+====|------------------------------------------------------------------
-----------#######----------------------|............|------------------------------------|==========|------------------
-----------------#----------------------|....W...F...|------------------------------------|F>...*....|------------------
-----------------#----------------------|......O.....|-----------------###################+.G...B.T..|------------------
-----------------#----------------------|............|-----------------#------------------|.T.O......|------------------
---------------|=+======|---------------|.....H......@##################------------------|.......T.G|------------------
---------------|........|---------------|..........T.|------------------------------------|..........|------------------
---------------|...F..T.|---------------|............|------------------------------------|..........|------------------
---------------|.O...Z..|---------------|............|------------------------------------|==========|------------------
---------------|.....H..|---------------|===_========|------------------------------------------------------------------
---------------|....Z...|-------------------#---------------------------------------------------------------------------
---------------|........|-------------------#-----------|=====|---------------------------------------------------------
---------------|====+===|-----|======|------#-----------|....C|---------------------------------------------------------
--------------------#---------|F.A...|------#-----------|..F..|---------------------------------------------------------
--------------------##########+.W....|------#-----------|.C..G|---------------------------------------------------------
------------------------------|F.....|------############+G..O.|---------------------------------------------------------
------------------------------|======|------------------|.....|---------------------------------------------------------
--------------------------------------------------------|=====|---------------------------------------------------------
------------------------------------------------------------------------------------------------------------------------
------------------------------------------------------------------------------------------------------------------------
------------------------------------------------------------------------------------------------------------------------
