------------------------------------------------------------------------------------------------------------------------
-------|========|-------------------------------------------------------------------------------------------------------
-------|&.......|-------------------------------------------------------------------------------------------------------
-------|..F....D+##################################---------------------------------------------------------------------
-------|.....T..|---------------------------------#---------------------------------------------------------------------
-------|........|---------------------------------#----------------------------------|========|-------------------------
-------|.<......|---------------------------------#----------------------------------|......>.|-------------------------
-------|=@======|---------------------------------#----------------------------------|..O.....|-------------------------
---------##########-------------------------------#----------------------------------|......F.|-------------------------
------------------#-------------------------------#----------------------------------|.TO.B..G|-------------------------
------------------#---------------------------|===+======|---------------------------|.T......|-------------------------
------------------#---------------------------|..........|---------------------------|.....T..|-------------------------
------------------#---------------------------|......T...|-------------##############+........|-------------------------
------------|=====+=|-------------------------|F......W..|-------------#-------------|........|-------------------------
------------|Z......|-------------------------|..........|-------------#-------------|....TG..|-------------------------
------------|......*|-------------------------|...O......|-------------#-------------|........|-------------------------
------------|.O.....|-------------------------|..........+##############-------------|========|-------------------------
------------|..F.T..|-------------------------|C.........|--------------------------------------------------------------
------------|......Z|-------------------------|======_===|--------------------------------------------------------------
------------|.......|--------------------------------#------------------------------------------------------------------
------------|H......|--------------------------------#------------------------------------------------------------------
------------|==+====|--------------------------------#------------------------------------------------------------------
---------------#------------|=========|--------------#------------------------------------------------------------------
---------------#------------|.........|--------------#-------|========|-------------------------------------------------
---------------#------------|...W...S.|--------------#-------|.....Z.F|-------------------------------------------------
---------------#############+..F......|--------------########+...O....|-------------------------------------------------
----------------------------|.......F.|----------------------|..G....H|-------------------------------------------------
----------------------------|=========|----------------------|========|-------------------------------------------------
------------------------------------------------------------------------------------------------------------------------
------------------------------------------------------------------------------------------------------------------------
