------------------------------------------------------------------------------------------------------------------------
------------------------------------------------------------------------------------------------------------------------
------|=====|-----------------------------------------------------------------------------------------------------------
------|&....|-----------------------------------------------------------------------------------------------------------
------|..OF.|-----------------------------------------------------------------------------------------------------------
------|...<.|-----------------------------------------------------------------------------------------------------------
------|...../#######################################--------------------------------------------------------------------
------|.....|--------------------------------------#--------------------------------------------------------------------
------|...T.|--------------------------------------#--------------------------------------------------------------------
------|.....|--------------------------------------#------------------------------|==============|----------------------
------|===@=|---------------------------------|====+=|----------------------------|.........G....|----------------------
----------###########-------------------------|......|----------------------------|.....O........|----------------------
--------------------#-------------------------|...O..|----------------------------|...........G..|----------------------
-------------|======+==|----------------------|......@##############--------------|...T..........|----------------------
-------------|.........|----------------------|.ZD...|-------------#--------------|.T.T..........|----------------------
-------------|.........|----------------------|......|-------------#--------------|..............|----------------------
-------------|...CZ.TO.|----------------------|..F...|-------------#--------------|..............|----------------------
-------------|...C.....|----------------------|......|-------------#--------------|..............|----------------------
-------------|....F....|----------------------|......|-------------#--------------|.T........F...|----------------------
-------------|.........|----------------------|====_=|-------------###############+....BO........|----------------------
-------------|===+=====|---------------------------#------------------------------|..............|----------------------
-----------------#----------|=======|--------------#------------------------------|.>............|----------------------
-----------------#----------|F....M.|--------------#-----------|=========|--------|..............|----------------------
-----------------###########+....F..|--------------#-----------|.*Z.G....|--------|==============|----------------------
----------------------------|......D|--------------############+..O..G...|----------------------------------------------
----------------------------|=======|--------------------------|....F....|----------------------------------------------
---------------------------------------------------------------|=========|----------------------------------------------
------------------------------------------------------------------------------------------------------------------------
------------------------------------------------------------------------------------------------------------------------
------------------------------------------------------------------------------------------------------------------------
