------------------------------------------------------------------------------------------------------------------------
------------------------------------------------------------------------------------------------------------------------
----------------------------|=============|-----------------------------------------------------------------------------
----------------------------|.............|-----------------------------------------------------------------------------
----------------------------|.............|-----|==============|--------------------------------------------------------
----------------------------|.............|-----|..............|--------------------------------------------------------
----------------------------|....U...S..F.+#####+..............+########################--------------------------------
----------------------------|Z............|-----|..............|-----------------------#--------------------------------
----------------------------|.............|-----|..............|-----------------------#--------------------------------
---------###################+.............|-----|..............|-----------------------#--------------------------------
---------#------------------|..O....T.....|-----|..............|-----------------|=====+========|-----------------------
---------#------------------|.............|-----|*.O...........|-----------------|B.G..B.....B..|-----------------------
-----|===_====|-------------|.............|-----|.Q............|-----------------|Q..........G..|-----------------------
-----|&.......|-------------|.............|-----|.C............|-----------------|......T..GB...|-----------------------
-----|.....T..|-------------|=============|-----|....L.C......G|-----------------|..............|-----------------------
-----|....K...|---------------------------------|.....C...HG...|-----------------|.............G|-----------------------
-----|...<....|---------------------------------|==============|-----------------|.T.T........>.|-----------------------
-----|...WF...|------------------------------------------------------------------|..............|-----------------------
-----|........|------------------------------------------------------------------|.T....G....GO.|-----------------------
-----|........|------------------------------|===============|-------------------|.G.......G.B..|-----------------------
-----|........|---------|========|-----------|...............|-------------------|==============|-----------------------
-----|........|---------|........|-----------|....U...S.....W|----------------------------------------------------------
-----|==@=====|---------|.C.N.T..@###########+....Q......D...|----------------------------------------------------------
--------#---------------|........|-----------|...............|----------------------------------------------------------
--------################+...O....|-----------|....F.F........|----------------------------------------------------------
------------------------|........|-----------|.......Q.......|----------------------------------------------------------
------------------------|..C..ZE.|-----------|===============|----------------------------------------------------------
------------------------|========|--------------------------------------------------------------------------------------
------------------------------------------------------------------------------------------------------------------------
------------------------------------------------------------------------------------------------------------------------
