------------------------------------------------------------------------------------------------------------------------
-----|=======|----------------------------------------------------------------------------------------------------------
-----|.......|----------------------------------------------------------------------------------------------------------
-----|.......|----------------------------------------------------------------------------------------------------------
-----|.......|----------------------------------------------------------------------------------------------------------
-----|...V...+####################################----------------------------------------------------------------------
-----|.......|-----------------------------------#----------------------------------------------------------------------
-----|.......|-----------------------------------#--------------------------------|============|------------------------
-----|.X..F..|--------------------------|========+====|---------------------------|.......B....|------------------------
-----|====+==|--------------------------|..C.......F..|---------------------------|............|------------------------
----------##########--------------------|.............|---------------------------|*...........|------------------------
-------------------#--------------------|.............|---------------------------|......O..O>.|------------------------
-------------------#--------------------|..D..........@###########################+.F..T.G.....|------------------------
-------------------#--------------------|.............|---------------------------|.TT.........|------------------------
-------------------#--------------------|.............|---------------------------|........G...|------------------------
-----------|=======+=|------------------|..O..T.......|---------------------------|............|------------------------
-----------|..Z......|------------------|.............|---------------------------|============|------------------------
-----------|..F......|------------------|====+========|-----------------------------------------------------------------
-----------|.........|-----------------------#--------------------------------------------------------------------------
-----------|.........|-----------------------#--------------------------------------------------------------------------
-----------|.OH.T....|-----------------------#--------------------------------------------------------------------------
-----------|.........|---------|=======|-----#-----------------|======|-------------------------------------------------
-----------|======+==|---------|....F..|-----#-----------------|..Z...|-------------------------------------------------
------------------#############+...A...|-----#-----------------|...O..|-------------------------------------------------
-------------------------------|.....D.|-----##################+....ZG|-------------------------------------------------
-------------------------------|=======|-----------------------|.....G|-------------------------------------------------
---------------------------------------------------------------|======|-------------------------------------------------
------------------------------------------------------------------------------------------------------------------------
------------------------------------------------------------------------------------------------------------------------
------------------------------------------------------------------------------------------------------------------------
