------------------------------------------------------------------------------------------------------------------------
------------------------------------------------------------------------------------------------------------------------
------------------------------------------------------------------------------------------------------------------------
------------------------------------------------------------------------------------------------------------------------
-----------------------------------|=======|----------------------------------------------------------------------------
-----------------------------------|Q......|--------------------------|===========|-------------------------------------
-----------------------------------|..O....|--------------------------|...........|--|=============|--------------------
-----------------------------------|...U..H|--------------------------|.Z.........|--|.............|--------------------
-----------------------------------|...C...|--------------------------|....N......@#-|.........GT..|--------------------
-----------------------------------|.......|--------------------------|H..........|#-|.............|--------------------
-----------------------------------|....C..|--------------------------|...........|#-|.>...........|--------------------
-----------------------------------|..T....|--------------------------|.......O...|##+............G|--------------------
-----------------------------------|.......|--------------------------|.......H.G.|--|G....OG......|--------------------
-----------------------------------|==+====|--------------------------|......*...C|--|.......G.....|--------------------
--------------------------------------#-------------------|=========|-|========+==|--|.........G...|--------------------
--------------------------------------#-------------------|......<..|----------#-----|.............|--------------------
--------|=====|-----------------------####################+..T......|----------#-----|.....T.O.....|--------------------
--------|.....|-------------------------------------------|...O...../###########-----|..G..........|--------------------
--------|..C..+##########---------------------------------|.........|----------------|.TQ..........|--------------------
--------|.....|---------#---------------------------------|.....L...|----------------|.......G....B|--------------------
--------|.....|---------#----------|=====|----------------|.Q.....D.|----------------|.............|--------------------
--------|.OE..|---------#----------|.....|----------------|==@======|----------------|.............|--------------------
--------|.TV..|---------#----------|.....|-------------------#-----------------------|...B.........|--------------------
--------|...A.|---------#----------|...SS|-------------------#-----------------------|.....G.B..T..|--------------------
--------|.....|---------#----------|.Q...|-------------------#-----------------------|.....B.......|--------------------
--------|=====|---------#----------|..Q..+####################-----------------------|.........B...|--------------------
------------------------#----------|.....|-------------------------------------------|=============|--------------------
------------------------###########/.....|------------------------------------------------------------------------------
-----------------------------------|.S.F.|------------------------------------------------------------------------------
-----------------------------------|=====|------------------------------------------------------------------------------
