------------------------------------------------------------------------------------------------------------------------
-----|======|----------------------------------------------------------------------------------|======|-----------------
-----|&.....|----------------------------------------------------------------------------------|......|-----------------
-----|.O..TE+###########-----------------------------------------------------------------------|...TUB|-----------------
-----|S.....|----------#-----------------------------------------------------------------------|....O.|-----------------
-----|...<..|----------#-----------------------------------------------------------------------|GT.GT.|-----------------
-----|......|----------#-----------------------------------------------------------------------|...O.B|-----------------
-----|.N....|----------#-----------------------------------------------------------------------|.G..T.|-----------------
-----|......|----------#-----------------------------------------------------------------------|.G....|-----------------
-----|======|----------#-----------------------------------------------------------------------|QG...>|-----------------
-----------------------#----------------------------------------------------|=========|--------|==+===|-----------------
------------------|====+==|-------------------------------------------------|H..C.....|-----------#---------------------
------------------|......Z|-------------------------------------------------|.....H..G|-----------#---------------------
------------------|...O...|-------------------------------------------------|....G....|-----------#---------------------
------------------|...T.E.|-------------------------------------------------|....Z*...|-----------#---------------------
------------------|....Z..|-------------------------------------------------|..LH.O.Q.+############---------------------
------------------|.......|-------------------------------------------------|.........|---------------------------------
------------------|.C.....|-------------------------------------------------|==+======|---------------------------------
------------------|.......|----------------------------------------------------#----------------------------------------
------------------|=@=====|----------------------------------------------------#----------------------------------------
--------------------#------------|======|-----------|======|-------------------#----------------------------------------
--------------------#------------|S...E.|-----------|......|-------------------#----------------------------------------
--------------------#------------|.N.D..|-----------|.C..Q./####################----------------------------------------
--------------------#############+......|-----------|...T..|------------------------------------------------------------
---------------------------------|E.E...|-----------|......|------------------------------------------------------------
---------------------------------|.....F@###########+..VD..|------------------------------------------------------------
---------------------------------|....S.|-----------|......|------------------------------------------------------------
---------------------------------|......|-----------|======|------------------------------------------------------------
---------------------------------|======|-------------------------------------------------------------------------------
------------------------------------------------------------------------------------------------------------------------
