------------------------------------------------------------------------------------------------------------------------
------------------------------------------------------------------------------------------------------------------------
------|=========|-------------------------------------------------------------------------------------------------------
------|.........|-------------------------------------------------------------------------------------------------------
------|........./#################################----------------------------------------------------------------------
------|....O..<.|--------------------------------#------------------------------|======|--------------------------------
------|.S....T..|--------------------------------#------------------------------|......|--------------------------------
------|..F......|--------------------------------#---------------###############+...O..|--------------------------------
------|=======+=|--------------------------------#---------------#--------------|..B.F.|--------------------------------
--------------########---------------------------#---------------#--------------|..T.T.|--------------------------------
---------------------#-------------------|=======+=|-------------#--------------|..O...|--------------------------------
---------------------#-------------------|.........|-------------#--------------|..>...|--------------------------------
---------------|=====+=|-----------------|.....F.M.+##############--------------|======|--------------------------------
---------------|.......|-----------------|..*......|--------------------------------------------------------------------
---------------|....TH.|-----------------|C.T.O....|--------------------------------------------------------------------
---------------|..O....|-----------------|.........|--------------------------------------------------------------------
---------------|.......|-----------------|=====+===|--------------------------------------------------------------------
---------------|.Z.....|-----------------------#------------------------------------------------------------------------
---------------|..H....|-----------------------#------------------------------------------------------------------------
---------------|=====+=|-----------------------#------------------------------------------------------------------------
---------------------#-------------------------#------------------------------------------------------------------------
---------------------#---------|=======|-------#------------------------------------------------------------------------
---------------------#---------|.FF..M.|-------#----------------|====|--------------------------------------------------
---------------------##########+.W.....|-------#----------------|.F..|--------------------------------------------------
-------------------------------|.......|-------#################+CO.G|--------------------------------------------------
-------------------------------|=======|------------------------|..Z.|--------------------------------------------------
----------------------------------------------------------------|====|--------------------------------------------------
------------------------------------------------------------------------------------------------------------------------
------------------------------------------------------------------------------------------------------------------------
------------------------------------------------------------------------------------------------------------------------
