------------------------------------------------------------------------------------------------------------------------
------|=====|-----------------------------------------------------------------------------------------------------------
------|&<...|-----------------------------------------------------------------------------------------------------------
------|..S..|-----------------------------------------------------------------------------------------------------------
------|...../#######################################--------------------------------------------------------------------
------|..O..|--------------------------------------#--------------------------------------------------------------------
------|.FT..|--------------------------------------#--------------------------------------------------------------------
------|.....|--------------------------------------#--------------------------------------------------------------------
------|==+==|-----------------------------|========+===|-------------------------|==============|-----------------------
---------########-------------------------|............|-------------------------|..G.B.........|-----------------------
----------------#-------------------------|.....W......|------------#############+.....O........|-----------------------
----------------#-------------------------|.........O..|------------#------------|.G......TT....|-----------------------
-------------|==+======|------------------|.Z..........|------------#------------|..T..T........|-----------------------
-------------|....H....|------------------|....T.......@#############------------|...>.F........|-----------------------
-------------|......Z..|------------------|......F.....|-------------------------|==============|-----------------------
-------------|......O..|------------------|............|----------------------------------------------------------------
-------------|.........|------------------|............|----------------------------------------------------------------
-------------|......TZ.|------------------|=====+======|----------------------------------------------------------------
-------------|.........|------------------------#-----------------------------------------------------------------------
-------------|.........|------------------------#-----------------------------------------------------------------------
-------------|===+=====|------------------------#-----------------------------------------------------------------------
-----------------#------------|=========|-------#-----------------------------------------------------------------------
-----------------#------------|.........|-------#---------------|======|------------------------------------------------
-----------------#############+F....AF..|-------#---------------|...Z..|------------------------------------------------
------------------------------|....D....|-------#---------------|...H..|------------------------------------------------
------------------------------|=========|-------################+......|------------------------------------------------
----------------------------------------------------------------|G*..O.|------------------------------------------------
----------------------------------------------------------------|......|------------------------------------------------
----------------------------------------------------------------|======|------------------------------------------------
------------------------------------------------------------------------------------------------------------------------
