------------------------------------------------------------------------------------------------------------------------
--------------------------------------------------------------------------------------------|=======|-------------------
-----|========|-----------------------------------------------------------------------------|.>...GG|-------------------
-----|&.......|-----------------------------------------------------------------------------|BGG....|-------------------
-----|..T..E..|-----------------------------------------------------------------------------|.BBT..G|-------------------
-----|....ON..+######-----------------------------------------------------------------------|.FT...G|-------------------
-----|..<..W..|-----#-----------------------------------------------------------------------|..GG...|-------------------
-----|========|-----#-----------------------------------------------------------------------|.......|-------------------
--------------------#-----------------------------------------------------------------------|....G..|-------------------
--------------------#-----------------------------------------------------------------------|..B....|-------------------
---------------|====+====|------------------------------------------------------------------|====+==|-------------------
---------------|.........|-----------------------------------------------|=======|---------------#----------------------
---------------|.OU......|-----------------------------------------------|....ZC.|---------------#----------------------
---------------|.........|-----------------------------------------------|H....O.+################----------------------
---------------|....CC...|-----------------------------------------------|....F..|--------------------------------------
---------------|...T.....|-----------------------------------------------|Z.G....|--------------------------------------
---------------|.FH......|-----------------------------------------------|..K.G..|--------------------------------------
---------------|======@==|-----------------------------------------------|....H..|--------------------------------------
----------------------#--------------------------------------------------|====+==|--------------------------------------
----------------------#-------------------------------------------------------#-----------------------------------------
----------------------#-----------|========|----------|======|----------------#-----------------------------------------
----------------------#-----------|........|----------|......|----------------#-----------------------------------------
----------------------#-----------|.*..E...|----------|......|----------------#-----------------------------------------
----------------------#-----------|........@##########+....L.|----------------#-----------------------------------------
----------------------############+.AF.S...|----------|...T..|----------------#-----------------------------------------
----------------------------------|.......Q|----------|..Q..Z/#################-----------------------------------------
----------------------------------|...D....|----------|D.....|----------------------------------------------------------
----------------------------------|========|----------|======|----------------------------------------------------------
------------------------------------------------------------------------------------------------------------------------
------------------------------------------------------------------------------------------------------------------------
