------------------------------------------------------------------------------------------------------------------------
-------------------------------------|=======|--------------------------------------------------------------------------
-------------------------------------|E...Z..|------------------------|============|------------------------------------
-------------------------------------|.Z..K..|------------------------|....Z....Z..|------------------------------------
-------------------------------------|.....T.|------------------------|H...C.......|------------------------------------
-------------------------------------|.......|------------------------|.....Z......+##--|=======|-----------------------
-------------------------------------|.C.....|------------------------|G.....V.O...|-#--|.......|-----------------------
-------------------------------------|.......|------------------------|G.....F.....|-#--|......G|-----------------------
-------------------------------------|====+==|------------------------|=========+==|-#--|....T..|-----------------------
------------------------------------------#-------------------------------------#----###+.......|-----------------------
------------------------------------------#-------------------------------------#-------|..TG...|-----------------------
------------------------------------------#-------------------------------------#-------|...TU..|-----------------------
------------------------------------------#-------------------------------------#-------|...O...|-----------------------
------------------------------------------#-------------------------------------#-------|.......|-----------------------
------------------------------------------#--------------|=====|----------------#-------|.......|-----------------------
------------------------------------------#--------------|.....|----------------#-------|.......|-----------------------
------------------------------------------#--------------|.....|----------------#-------|...>T..|-----------------------
------|=====|-----------------------------#--------------|..<../#################-------|Q......|-----------------------
------|.....|-----------------------------###############+.E...|------------------------|.......|-----------------------
------|...Q.+##############------------------------------|..T.W|------------------------|..O....|-----------------------
------|.ZO.A|-------------#--------------|========|------|.....|------------------------|.......|-----------------------
------|.L...|-------------#--------------|........|------|.....|------------------------|G..B...|-----------------------
------|.....|-------------#--------------|.E......|------|..L..|------------------------|.....G.|-----------------------
------|=====|-------------#--------------|........|------|.....|------------------------|G......|-----------------------
--------------------------#--------------|..F*....|------|==+==|------------------------|.....B.|-----------------------
--------------------------#--------------|........+##########---------------------------|=======|-----------------------
--------------------------#--------------|..S.....|---------------------------------------------------------------------
--------------------------###############/....D...|---------------------------------------------------------------------
-----------------------------------------|..E....D|---------------------------------------------------------------------
-----------------------------------------|========|---------------------------------------------------------------------
