------------------------------------------------------------------------------------------------------------------------
------|========|--------------------------------------------------------------------------------------------------------
------|&<......|--------------------------------------------------------------------------------------------------------
------|........|--------------------------------------------------------------------------------------------------------
------|.....F..|--------------------------------------------------------------------------------------------------------
------|..T.....+###########################################-------------------------------------------------------------
------|...O....|------------------------------------------#----------------------------|========|-----------------------
------|..D.....|------------------------------------------#----------------------------|........|-----------------------
------|........|------------------------------|===========+=|--------------------------|........|-----------------------
------|==+=====|------------------------------|.....C.D.....|--------------------------|....F...|-----------------------
---------############-------------------------|.............|--------------------------|.G......|-----------------------
--------------------#-------------------------|.............|--------------------------|......T.|-----------------------
--------------------#-------------------------|....F........|--------------------------|......>.|-----------------------
--------------|=====+=|-----------------------|.............@#############-------------|....TTG.|-----------------------
--------------|....C..|-----------------------|......T......|------------#-------------|........|-----------------------
--------------|.......|-----------------------|.......O.....|------------##############+B..O....|-----------------------
--------------|..T.H..|-----------------------|.............|--------------------------|........|-----------------------
--------------|.....H.|-----------------------|.............|--------------------------|..TO....|-----------------------
--------------|..F....|-----------------------|======+======|--------------------------|........|-----------------------
--------------|=====+=|------------------------------#---------------------------------|========|-----------------------
--------------------#--------------------------------#------------------------------------------------------------------
--------------------#--------------------------------#----|====|--------------------------------------------------------
--------------------#--------|=====|-----------------#----|..GG|--------------------------------------------------------
--------------------#--------|.....|-----------------#----|....|--------------------------------------------------------
--------------------#--------|F..D.|-----------------#####+.O.F|--------------------------------------------------------
--------------------#########+.....|----------------------|...*|--------------------------------------------------------
-----------------------------|.F..W|----------------------|====|--------------------------------------------------------
-----------------------------|=====|------------------------------------------------------------------------------------
------------------------------------------------------------------------------------------------------------------------
------------------------------------------------------------------------------------------------------------------------
