------------------------------------------------------------------------------------------------------------------------
-----|========|---------------------------------------------------------------------------------------------------------
-----|&<......|---------------------------------------------------------------------------------------------------------
-----|........|---------------------------------------------------------------------------------------------------------
-----|...S..F.+##############################################-----------------------------------------------------------
-----|......T.|---------------------------------------------#-----------------------------------------------------------
-----|......O.|---------------------------------------------#-----------------------------------------------------------
-----|........|---------------------------------------------#-----------------------------------------------------------
-----|===@====|----------------------------------|==========+=|---------------------|=====|-----------------------------
---------#########-------------------------------|...FHM......|---------------------|G....|-----------------------------
-----------------#-------------------------------|............|---------------------|.....|-----------------------------
-----------------#-------------------------------|............+###########----------|..TT.|-----------------------------
-----------------#-------------------------------|..O....T....|----------#----------|..O..|-----------------------------
-------------|===+=====|-------------------------|............|----------#----------|.....|-----------------------------
-------------|.........|-------------------------|==========+=|----------###########+.>G..|-----------------------------
-------------|.........|------------------------------------------------------------|.....|-----------------------------
-------------|.O..T....|------------------------------------------------------------|B..T.|-----------------------------
-------------|.........|------------------------------------------------------------|.T...|-----------------------------
-------------|..ZZ.....|------------------------------------------------------------|.....|-----------------------------
-------------|...F.....|------------------------------------------------------------|=====|-----------------------------
-------------|C........|---------------------------------|=========|----------------------------------------------------
-------------|=====+===|---------|========|--------------|......F.G|----------------------------------------------------
-------------------#-------------|...F..M.|--------------+.O....H..|----------------------------------------------------
-------------------##############+.....F..|--------------|..*....Z.|----------------------------------------------------
---------------------------------|...W....|--------------|=========|----------------------------------------------------
---------------------------------|========|-----------------------------------------------------------------------------
------------------------------------------------------------------------------------------------------------------------
------------------------------------------------------------------------------------------------------------------------
------------------------------------------------------------------------------------------------------------------------
------------------------------------------------------------------------------------------------------------------------
