------------------------------------------------------------------------------------------------------------------------
------------------------------------------------------------------------------------------------------------------------
------------------------------------------------------------------------------------------------------------------------
--------------------|=========|-----------------------------------------------------------------------------------------
--------------------|.........|----------------|=================|------------------------------------------------------
--------------------|.........|----------------|....H............|------------------------------------------------------
--------------------|.....E...|----------------|............E....|------------------------------------------------------
--------------------|....W..Z.|----------------|.................+#################-------------------------------------
--------------------|........./################+.................|----------------#-------------------------------------
--------------------|.........|----------------|........K..H.....|----------------#-------------------------------------
---------###########+*.O..U...|----------------|..C..H.....G.....|--------------|=+============|------------------------
---------#----------|.........|----------------|.................|--------------|..............|------------------------
--|======_=|--------|.......T.|----------------|........O........|--------------|..............|------------------------
--|&.......|--------|.........|----------------|....G............|--------------|...B...O...T..|------------------------
--|....K..E|--------|=========|----------------|.................|--------------|..........G...|------------------------
--|.OX..W..|-----------------------------------|....C............|--------------|.........G.T..|------------------------
--|........|-----------------------------------|=================|--------------|Q.............|------------------------
--|........|--------------------------------------------------------------------|..B........O..|------------------------
--|....T...|--------------------------------------------------------------------|GG............|------------------------
--|........|-----------------------------|===================|------------------|..............|------------------------
--|==@=====|-----------|=======|---------|...................|------------------|............>.|------------------------
-----#-----------------|.......|---------|........E..........|------------------|.T........GUT.|------------------------
-----#-----------------|.......|---------|.....F.......D.....|------------------|..............|------------------------
-----##################+...ON..+#########+...................|------------------|==============|------------------------
-----------------------|.....T.|---------|A......Q...........|----------------------------------------------------------
-----------------------|......H|---------|...E........S......|----------------------------------------------------------
-----------------------|..H..Z.|---------|===================|----------------------------------------------------------
-----------------------|=======|----------------------------------------------------------------------------------------
------------------------------------------------------------------------------------------------------------------------
------------------------------------------------------------------------------------------------------------------------
