------------------------------------------------------------------------------------------------------------------------
------------------------------------------------------------------------------------------------------------------------
-----|=========|--------------------------------------------------------------------------------------------------------
-----|&........|--------------------------------------------------------------------------------------------------------
-----|.........|--------------------------------------------------------------------------------------------------------
-----|<..O...../#########################################---------------------------------------------------------------
-----|.....T..W|----------------------------------------#---------------------------------------------------------------
-----|.........|----------------------------------------#--------------------------------|==========|-------------------
-----|.....F...|-------------------------------|========+==|-----------------------------|F.........|-------------------
-----|====@====|-------------------------------|..........A|-----------------------------|..........|-------------------
----------##########---------------------------|...T.......@###############--------------|..........|-------------------
-------------------#---------------------------|...........|--------------#--------------|..........|-------------------
-------------------#---------------------------|.....C.O.F.|--------------#--------------|.O........|-------------------
--------------|====+==|------------------------|...........|--------------#--------------|....*.>.T.|-------------------
--------------|.F.....|------------------------|===_=======|--------------###############+..G.......|-------------------
--------------|.T.Z.C.|----------------------------#-------------------------------------|...T.O..T.|-------------------
--------------|....O..|----------------------------#-------------------------------------|..B.......|-------------------
--------------|.......|----------------------------#-------------------------------------|.G........|-------------------
--------------|.......|----------------------------#-------------------------------------|==========|-------------------
--------------|=+=====|----------------------------#--------------------------------------------------------------------
----------------#----------------------------------#--------------------------------------------------------------------
----------------#--------------|=========|---------#--------------------------------------------------------------------
----------------#--------------|.......FM|---------#-----|=======|------------------------------------------------------
----------------###############+.........|---------#-----|..H....|------------------------------------------------------
-------------------------------|F........|---------#-----|...F.G.|------------------------------------------------------
-------------------------------|=========|---------#-----|C...O..|------------------------------------------------------
---------------------------------------------------######+.G.....|------------------------------------------------------
---------------------------------------------------------|.......|------------------------------------------------------
---------------------------------------------------------|=======|------------------------------------------------------
------------------------------------------------------------------------------------------------------------------------
