------------------------------------------------------------------------------------------------------------------------
------------------------------------------------------------------------------------------------------------------------
------|=======|---------------------------------------------------------------------------------------------------------
------|&.....A|---------------------------------------------------------------------------------------------------------
------|.......+######################################-------------------------------------------------------------------
------|..T....|-------------------------------------#--------------------------------|=======|--------------------------
------|.....K.|---------------------------------|===+=====|--------------------------|...F...|--------------------------
------|.X...O.|---------------------------------|.........|--------------------------|.......|--------------------------
------|.*....Q|---------------------------------|.........|--------------------------|.OBG...|--------------------------
------|=====+=|---------------------------------|D..K..OHF@#############-------------|.......|--------------------------
------------######------------------------------|.T.......|------------##############+...T...|--------------------------
-----------------#------------------------------|.........|--------------------------|.G..U..|--------------------------
-----------------#------------------------------|=====+===|--------------------------|.......|--------------------------
-----------------#------------------------------------#------------------------------|..T....|--------------------------
-------------|===+==|---------------------------------#------------------------------|.....GB|--------------------------
-------------|..FH..|---------------------------------#------------------------------|>..OT..|--------------------------
-------------|..V.Z.|---------------------------------#------------------------------|.......|--------------------------
-------------|......|--------|======|-----------------#------------------------------|.......|--------------------------
-------------|..Z.T.|--------|....F.|-----------------#------------------------------|...GG..|--------------------------
-------------|......|--------|......|-----------------#------------------------------|=======|--------------------------
-------------|==+===|--------|.S....|-----------------#-----|=============|---------------------------------------------
----------------#------------|....Q.|-----------------#-----|.......Z.G...|---------------------------------------------
----------------#------------|.....Q|-----------------######+.............|---------------------------------------------
----------------#############+......|-----------------------|.............|---------------------------------------------
-----------------------------|..E...|-----------------------|.......C.....|---------------------------------------------
-----------------------------|..A...|-----------------------|........CC...|---------------------------------------------
-----------------------------|....A.|-----------------------|....C.......G|---------------------------------------------
-----------------------------|======|-----------------------|=============|---------------------------------------------
------------------------------------------------------------------------------------------------------------------------
------------------------------------------------------------------------------------------------------------------------
