------------------------------------------------------------------------------------------------------------------------
-------|======|---------------------------------------------------------------------------------------------------------
-------|&...<.|---------------------------------------------------------------------------------------------------------
-------|..T...|---------------------------------------------------------------------------------------------------------
-------|......+#######################################------------------------------------------------------------------
-------|......|--------------------------------------#------------------------------------------------------------------
-------|.F..O.|--------------------------------------#------------------------------------------------------------------
-------|....W.|--------------------------------------#------------------------------------------------------------------
-------|......|--------------------------------------#------------------------------------------------------------------
-------|===+==|-------------------------------|======+==|---------------------------------------------------------------
-----------#####------------------------------|.........|----------------------------|============|---------------------
---------------#------------------------------|.......S.|----------------------------|.....>......|---------------------
------------|==+====|-------------------------|..O......@############################+G..TO..T....|---------------------
------------|.......|-------------------------|.........|----------------------------|G.........T.|---------------------
------------|...H...|-------------------------|......T..|----------------------------|F..O.....T..|---------------------
------------|...TC..|-------------------------|C...F....|----------------------------|.......B....|---------------------
------------|.Z.....|-------------------------|===_=====|----------------------------|============|---------------------
------------|....F..|-----------------------------#---------------------------------------------------------------------
------------|.......|-----------------------------#---------------------------------------------------------------------
------------|=====+=|-----------------------------#---------------------------------------------------------------------
------------------#-------------------------------#---------------------------------------------------------------------
------------------#-------------------------------#---------------------------------------------------------------------
------------------#-------------|=========|-------#---------------------------------------------------------------------
------------------#-------------|......A..|-------#-------------|=========|---------------------------------------------
------------------#-------------|.........|-------#-------------|......H..|---------------------------------------------
------------------##############+.........|-------##############+.G.......|---------------------------------------------
--------------------------------|AF.......|---------------------|*........|---------------------------------------------
--------------------------------|=========|---------------------|.C......G|---------------------------------------------
----------------------------------------------------------------|=========|---------------------------------------------
------------------------------------------------------------------------------------------------------------------------
