------------------------------------------------------------------------------------------------------------------------
-------|=====|----------------------------------------------------------------------------------------------------------
-------|&....|----------------------------------------------------------------------------------------------------------
-------|...../################################--------------------------------------------------------------------------
-------|.T.D.|-------------------------------#--------------------------------------------------------------------------
-------|.....|-------------------------------#--------------------------------------------------------------------------
-------|X.OF.|-------------------------------#-------------------------------------------|========|---------------------
-------|.....|-------------------------------#-------------------------------------------|........|---------------------
-------|..*..|-------------------------------#----------------------#####################+......T.|---------------------
-------|=@===|---------------------------|===+=|--------------------#--------------------|.......>|---------------------
---------##############------------------|.....|--------------------#--------------------|........|---------------------
----------------------#------------------|.....|--------------------#--------------------|....O.T.|---------------------
----------------------#------------------|...OF@#####################--------------------|.O......|---------------------
----------------------#------------------|..HD.|-----------------------------------------|........|---------------------
----------------------#------------------|.....|-----------------------------------------|..GF....|---------------------
---------------|======+=|----------------|===_=|-----------------------------------------|........|---------------------
---------------|......H.|--------------------#-------------------------------------------|........|---------------------
---------------|........|--------------------#-------------------------------------------|.T.T....|---------------------
---------------|........|--------------------#-------------------------------------------|........|---------------------
---------------|....T...|--------------------#-------------------------------------------|.B......|---------------------
---------------|......O.|--------------------#-------------------------------------------|...G....|---------------------
---------------|......F.|----|=====|---------#-------------------------------------------|========|---------------------
---------------|.Z..C...|----|.....|---------#---------------|=====|----------------------------------------------------
---------------|===##########+A....|---------#---------------|..G..|----------------------------------------------------
-----------------------------|.F.SF|---------#---------------|.....|----------------------------------------------------
-----------------------------|=====|---------#---------------|.....|----------------------------------------------------
---------------------------------------------################+FZZOG|----------------------------------------------------
-------------------------------------------------------------|.....|----------------------------------------------------
-------------------------------------------------------------|=====|----------------------------------------------------
------------------------------------------------------------------------------------------------------------------------
