------------------------------------------------------------------------------------------------------------------------
-----------|________|---------------------------------------------------------------------------------------------------
-----------|........|---------------------------------------------------------------------------------------------------
-----------|.X......|---------------------------------------------------------------------------------------------------
-----------|........|---------------------------------------------------------------------------------------------------
-----------|........|---------------------------------------------------------------------------------------------------
-----------|____+___|---------------------------------------------------------------------------------------------------
----------------#----------------------------------------|________|-----------------------------------------------------
----------------#----------------------------------------|........|-----------------------------------------------------
----------------######-----------------------------------|........|---------------------------|________|----------------
---------------------#-----------------------------------|........+######################-----|........|----------------
-----------------|___+____|------------------------------|........|---------------------######+...O....|----------------
-----------------|........|------------------------------|_____+__|---------------------------|........|----------------
-----------------|........|------------------------------------#------------------------------|........|----------------
-----------------|..O.....|------------------------------------#------------------------------|........|----------------
-----------------|........|------------------------------------########-----------------------|........|----------------
-----------------|______+_|-------------------------------------------#-----------------------|.....S..|----------------
------------------------#---------------------------------------------#-----------------------|________|----------------
------------------------#---------------------------------------------#-------------------------------------------------
------------------------################---------------------------|__+_____|-------------------------------------------
---------------------------------------#---------------------------|........|-------------------------------------------
-----------------------------------|___+____|----------------------|........|-------------------------------------------
-----------------------------------|........|---------------#######+....O...|-------------------------------------------
-----------------------------------|........|---------------#------|........|-------------------------------------------
-----------------------------------|........+################------|________|-------------------------------------------
-----------------------------------|.....O..|---------------------------------------------------------------------------
-----------------------------------|________|---------------------------------------------------------------------------
------------------------------------------------------------------------------------------------------------------------
------------------------------------------------------------------------------------------------------------------------
------------------------------------------------------------------------------------------------------------------------