------------------------------------------------------------------------------------------------------------------------
------------------------------------------------------------------------------------------------------------------------
-----|=========|--------------------------------------------------------------------------------------------------------
-----|&........|--------------------------------------------------------------------------------------------------------
-----|.....O<../################################------------------------------------------------------------------------
-----|.W....T..|-------------------------------#------------------------------------------------------------------------
-----|.........|-------------------------------#------------------------------------------------------------------------
-----|...F.....|-------------------------------#------------------------------------------------------------------------
-----|.........|-------------------------------#------------------------------------------------------------------------
-----|=@=======|------------------------|======+=======|----------------------------------------------------------------
-------############---------------------|..............|-------------------------|=========|----------------------------
------------------#---------------------|..........T...|-------------------------|.........|----------------------------
------------------#---------------------|..............|-------------------------|.........|----------------------------
------------------#---------------------|..............@#############------------|..O......|----------------------------
--------------|===+=====|---------------|.....H........|------------#------------|.......T.|----------------------------
--------------|.........|---------------|...F.....O....|------------#############+.........|----------------------------
--------------|Z.....O..|---------------|..............|-------------------------|.....T.G.|----------------------------
--------------|......T..|---------------|........S.....|-------------------------|.........|----------------------------
--------------|...H....C|---------------|=======+======|-------------------------|.........|----------------------------
--------------|.......F.|-----------------------#--------------------------------|.....>...|----------------------------
--------------|.........|-----------------------#--------------------------------|......G..|----------------------------
--------------|=+=======|---|=======|-----------#--------------------------------|.....T...|----------------------------
----------------#-----------|......F|-----------#------------|=====|-------------|.B.O.....|----------------------------
----------------############+.D..S..|-----------#------------|*....|-------------|F........|----------------------------
----------------------------|F......|-----------#############+.OZG.|-------------|.........|----------------------------
----------------------------|=======|------------------------|Z..FG|-------------|=========|----------------------------
-------------------------------------------------------------|=====|----------------------------------------------------
------------------------------------------------------------------------------------------------------------------------
------------------------------------------------------------------------------------------------------------------------
------------------------------------------------------------------------------------------------------------------------
