------------------------------------------------------------------------------------------------------------------------
------------------------------------------------------------------------------------------------------------------------
-------|======|---------------------------------------------------------------------------------------------------------
-------|&.....|---------------------------------------------------------------------------------------------------------
-------|......+######################################-------------------------------------------------------------------
-------|.O.TA.|-------------------------------------#-------------------------------------------------------------------
-------|F...<.|-------------------------------------#-----------------------------|==============|----------------------
-------|......|-------------------------------------#-----------------------------|..............|----------------------
-------|===+==|-------------------------------------#-------------------##########+..........T.O.|----------------------
-----------####----------------------------------|==+==========|--------#---------|G.>...B.......|----------------------
--------------#----------------------------------|....F........|--------#---------|F..T...O......|----------------------
--------------#----------------------------------|.............|--------#---------|..G.T.........|----------------------
--------------#----------------------------------|.............|--------#---------|..............|----------------------
--------------#----------------------------------|....D...*....|--------#---------|==============|----------------------
--------------#----------------------------------|......Z......@#########-----------------------------------------------
-----------|==+====|-----------------------------|.............|--------------------------------------------------------
-----------|..C....|-----------------------------|...T.........|--------------------------------------------------------
-----------|.T.Z...|-----------------------------|.....O.......|--------------------------------------------------------
-----------|.....H.|-----------------------------|.............|--------------------------------------------------------
-----------|.......|-----------------------------|=====_=======|--------------------------------------------------------
-----------|...F.O.|-----------------------------------#----------------------------------------------------------------
-----------|.......|-----------|=====|-----------------#----------------------------------------------------------------
-----------|====+==|-----------|..DF.|-----------------#--------|=====|-------------------------------------------------
----------------###############+.F...|-----------------#--------|..C..|-------------------------------------------------
-------------------------------|....S|-----------------#########+CO.G.|-------------------------------------------------
-------------------------------|=====|--------------------------|..F.G|-------------------------------------------------
----------------------------------------------------------------|=====|-------------------------------------------------
------------------------------------------------------------------------------------------------------------------------
------------------------------------------------------------------------------------------------------------------------
------------------------------------------------------------------------------------------------------------------------
