------------------------------------------------------------------------------------------------------------------------
------------------------------------------------------------------------------------------------------------------------
-------|=======|--------------------------------------------------------------------------|==========|------------------
-------|.X.....|--------------------------------------------------------------------------|..........|------------------
-------|.Q.....|--------------------------------------------------------------------------|....G.B...|------------------
-------|...T.../#################################-----------------------------------------|...U......|------------------
-------|..O....|---------------------------|====+=|---------------------------------------|.GB.......|------------------
-------|.......|---------------------------|......|-------------------####################+....T.....|------------------
-------|..V....|---------------------------|W.....|-------------------#-------------------|..O....>..|------------------
-------|.D...*.|---------------------------|......+####################-------------------|..........|------------------
-------|====+==|---------------------------|..E...|---------------------------------------|......O...|------------------
------------#####--------------------------|....O.|---------------------------------------|..........|------------------
----------------#--------------------------|...H..|---------------------------------------|........G.|------------------
----------------#--------------------------|...L..|---------------------------------------|......G...|------------------
----------------#--------------------------|..T...|---------------------------------------|..........|------------------
-----------|====+===|----------------------|......|---------------------------------------|.TG..E....|------------------
-----------|........|----------------------|===_==|---------------------------------------|..........|------------------
-----------|.......F|-------|======|-----------#------------------------------------------|==========|------------------
-----------|.......C|-------|......|-----------#------------------------------------------------------------------------
-----------|..HV....|-------|......|-----------#-----------------|==============|---------------------------------------
-----------|........|-------|......|-----------#-----------------|............H.|---------------------------------------
-----------|===+====|-------|......|-----------##################+........O.HZ..|---------------------------------------
---------------#------------|..QE.S|-----------------------------|.....Q........|---------------------------------------
---------------#------------|..U...|-----------------------------|...........V..|---------------------------------------
---------------#------------|W.S...|-----------------------------|..Z........G..|---------------------------------------
---------------#------------|......|-----------------------------|.........G.Z..|---------------------------------------
---------------#############+F....Q|-----------------------------|==============|---------------------------------------
----------------------------|======|------------------------------------------------------------------------------------
------------------------------------------------------------------------------------------------------------------------
------------------------------------------------------------------------------------------------------------------------
