------------------------------------------------------------------------------------------------------------------------
------------------------------------------------------------------------------------------------------------------------
-----|========|---------------------------------------------------------------------------------------------------------
-----|&...<...|---------------------------------------------------------------------------------------------------------
-----|......M.|---------------------------------------------------------------------------------------------------------
-----|..T...O./###################################----------------------------------------------------------------------
-----|........|----------------------------------#----------------------------------------------------------------------
-----|.....F..|----------------------------------#------------------------------|=====|---------------------------------
-----|........|----------------------------------#------------------------------|...>G|---------------------------------
-----|=+======|----------------------------------#--------------------##########+.T...|---------------------------------
-------#########-----------------------------|===+==========|---------#---------|..OG.|---------------------------------
---------------#-----------------------------|......F.......|---------#---------|..BTF|---------------------------------
---------------#-----------------------------|...T...W......|---------#---------|.....|---------------------------------
---------------#-----------------------------|..............|---------#---------|=====|---------------------------------
---------------#-----------------------------|..............|---------#-------------------------------------------------
-----------|===+=|---------------------------|...O....C.....@##########-------------------------------------------------
-----------|.....|---------------------------|..............|-----------------------------------------------------------
-----------|.....|---------------------------|..............|-----------------------------------------------------------
-----------|.....|---------------------------|========+=====|-----------------------------------------------------------
-----------|.CTO.|------------------------------------#-----------------------------------------------------------------
-----------|..H..|------------------------------------#-----------------------------------------------------------------
-----------|===+=|---------------|=====|--------------#---|=====|-------------------------------------------------------
---------------#-----------------|.F...|--------------#---|.....|-------------------------------------------------------
---------------##################+.....|--------------#---|.Z...|-------------------------------------------------------
---------------------------------|D...*|--------------####+HGFO.|-------------------------------------------------------
---------------------------------|=====|------------------|G....|-------------------------------------------------------
----------------------------------------------------------|=====|-------------------------------------------------------
------------------------------------------------------------------------------------------------------------------------
------------------------------------------------------------------------------------------------------------------------
------------------------------------------------------------------------------------------------------------------------
