------------------------------------------------------------------------------------------------------------------------
-----------|________|---------------------------------------------------------------------------------------------------
-----------|........|---------------------------------------------------------------------------------------------------
-----------|.X......|---------------------------------------------------------------------------------------------------
-----------|........|---------------------------------------------------------------------------------------------------
-----------|..T.....|---------------------------------------------------------------------------------------------------
-----------|____+___|---------------------------------------------------------------------------------------------------
----------------#----------------------------------------|________|-----------------------------------------------------
----------------#----------------------------------------|........|-----------------------------------------------------
----------------#----------------------------------------|........|---------------------------|________|----------------
----------------######-----------------------------------|........+######################-----|........|----------------
---------------------#-----------------------------------|........|---------------------######+...O....|----------------
---------------------#-----------------------------------|_____+__|---------------------------|........|----------------
-----------------|___+____|------------------------------------#------------------------------|........|----------------
-----------------|........|------------------------------------#------------------------------|........|----------------
-----------------|........|------------------------------------########-----------------------|........|----------------
-----------------|..O.....|-------------------------------------------#-----------------------|.....>..|----------------
-----------------|........|-------------------------------------------#-----------------------|________|----------------
-----------------|______+_|-------------------------------------------#-------------------------------------------------
------------------------#------------------------------------------|__+_____|-------------------------------------------
------------------------#------------------------------------------|........|-------------------------------------------
------------------------################---------------------------|........|-------------------------------------------
---------------------------------------#---------------------------|....O...|-------------------------------------------
-----------------------------------|___+____|----------------------|........|-------------------------------------------
-----------------------------------|........|----------------------|____+___|-------------------------------------------
-----------------------------------|.....O..|---------------------------#-----------------------------------------------
-----------------------------------|........+############################-----------------------------------------------
-----------------------------------|..T.....|---------------------------------------------------------------------------
-----------------------------------|________|---------------------------------------------------------------------------
------------------------------------------------------------------------------------------------------------------------