------------------------------------------------------------------------------------------------------------------------
------------------------------------------------------------------------------------------------------------------------
-----|========|---------------------------------------------------------------------------------------------------------
-----|&.......|---------------------------------------------------------------------------------------------------------
-----|...O....|---------------------------------------------------------------------------------------------------------
-----|....F.../#################################------------------------------------------------------------------------
-----|.......<|--------------------------------#------------------------------------------------------------------------
-----|...M....|--------------------------------#---------------------------------|===========|--------------------------
-----|........|--------------------------------#---------------------------------|...........|--------------------------
-----|........|--------------------------------#---------------------------------|.B.........|--------------------------
-----|=+======|------------------------------|=+=====|---------------------------|.....T.....|--------------------------
-------############--------------------------|...W...|---------------------------|..........F|--------------------------
------------------#--------------------------|.......@###########################+..O......T.|--------------------------
-------------|====@===|----------------------|...O...|---------------------------|.......G...|--------------------------
-------------|.....Z.C|----------------------|F......|---------------------------|..........G|--------------------------
-------------|..O.....|----------------------|.......|---------------------------|...........|--------------------------
-------------|F....T..|----------------------|.......|---------------------------|.O.T..T...>|--------------------------
-------------|.......C|----------------------|....TZ.|---------------------------|...........|--------------------------
-------------|........|----------------------|.......|---------------------------|===========|--------------------------
-------------|===+====|----------------------|===_===|------------------------------------------------------------------
-----------------#-------------------------------#----------------------------------------------------------------------
-----------------#-------------------------------#----------------------------------------------------------------------
-----------------#--------------|========|-------#-----------|=====|----------------------------------------------------
-----------------#--------------|...*....|-------#-----------|G....|----------------------------------------------------
-----------------#--------------|...D...W|-------############+.O.G.|----------------------------------------------------
-----------------###############+....F...|-------------------|..CZ.|----------------------------------------------------
--------------------------------|........|-------------------|=====|----------------------------------------------------
--------------------------------|========|------------------------------------------------------------------------------
------------------------------------------------------------------------------------------------------------------------
------------------------------------------------------------------------------------------------------------------------
