------------------------------------------------------------------------------------------------------------------------
-------|=========|------------------------------------------------------------------------------------------------------
-------|&........|------------------------------------------------------------------------------------------------------
-------|.........+#############################-------------------------------------------------------------------------
-------|.........|----------------------------#-------------------------------------------------------------------------
-------|.T.......|----------------------------#-------------------------------------------------------------------------
-------|.A.......|----------------------------#-------------------------------------------------------------------------
-------|....O.F..|----------------------------#-------------------------------------------------------------------------
-------|........<|----------------------------#-------------------------------------------------------------------------
-------|==+======|----------------------------#-----------------------------------------|===========|-------------------
----------#######-------------------------|===+=====|-----------------------------------|G..........|-------------------
----------------#-------------------------|.........|-----------------------------------|...B...O...|-------------------
----------------#-------------------------|....O....|-----------------------------------|......T..>.|-------------------
----------------#-------------------------|......Z..|-----------------##################+...........|-------------------
-----------|====+=|-----------------------|...T.....|-----------------#-----------------|..T........|-------------------
-----------|......|-----------------------|.........|-----------------#-----------------|..O...F..T.|-------------------
-----------|ZHT.F.|-----------------------|.........@##################-----------------|........G..|-------------------
-----------|.....H|-----------------------|.........|-----------------------------------|===========|-------------------
-----------|......|-----------------------|..WF.....|-------------------------------------------------------------------
-----------|.O....|-----------------------|======_==|-------------------------------------------------------------------
-----------|......|------------------------------#----------------------------------------------------------------------
-----------|......|-------------|======|---------#-----------|=========|------------------------------------------------
-----------|===+==|-------------|..S..*|---------#-----------|.Z.....ZF|------------------------------------------------
---------------#################+......|---------#-----------|.O.......|------------------------------------------------
--------------------------------|...F.W|---------############+.........|------------------------------------------------
--------------------------------|======|---------------------|G.G......|------------------------------------------------
-------------------------------------------------------------|=========|------------------------------------------------
------------------------------------------------------------------------------------------------------------------------
------------------------------------------------------------------------------------------------------------------------
------------------------------------------------------------------------------------------------------------------------
