------------------------------------------------------------------------------------------------------------------------
-----|=======|-------------------------------------------------------------------------------|========|-----------------
-----|&.Q....|-------------------------------------------------------------------------------|>.G.....|-----------------
-----|.A..<O./######-------------------------------------------------------------------------|..T..G..|-----------------
-----|.....V.|-----#-------------------------------------------------------------------------|BB......|-----------------
-----|....T..|-----#-------------------------------------------------------------------------|.TG.GT..|-----------------
-----|.......|-----#-------------------------------------------------------------------------|..G...G.|-----------------
-----|=======|-----#-------------------------------------------------------------------------|....OB.Q|-----------------
-------------------#-------------------------------------------------------------------------|.G......|-----------------
-------------------#-------------------------------------------------------------------------|.B.GB...|-----------------
-----------------|=+====|--------------------------------------------------------------------|===+====|-----------------
-----------------|......|----------------------------------------------------|========|----------#----------------------
-----------------|..T.O.|----------------------------------------------------|........|----------#----------------------
-----------------|H.....|----------------------------------------------------|......H.|----------#----------------------
-----------------|....HZ|----------------------------------------------------|.O......+###########----------------------
-----------------|..Q...|----------------------------------------------------|...NHZQ.|---------------------------------
-----------------|=@====|----------------------------------------------------|...H..GC|---------------------------------
-------------------#---------------------------------------------------------|===+====|---------------------------------
-------------------#-------------------------------------------------------------#--------------------------------------
-------------------#---------------|=======|-------------|=====|-----------------#--------------------------------------
-------------------#---------------|..S.FF.|-------------|.....|-----------------#--------------------------------------
-------------------################+....D.E|-------------|.....|-----------------#--------------------------------------
-----------------------------------|....*..|-------------|...H.|-----------------#--------------------------------------
-----------------------------------|.E.....@#############+.....|-----------------#--------------------------------------
-----------------------------------|.......|-------------|.....+##################--------------------------------------
-----------------------------------|.......|-------------|.ON..|--------------------------------------------------------
-----------------------------------|...S...|-------------|...T.|--------------------------------------------------------
-----------------------------------|=======|-------------|.ES..|--------------------------------------------------------
---------------------------------------------------------|=====|--------------------------------------------------------
------------------------------------------------------------------------------------------------------------------------
