------------------------------------------------------------------------------------------------------------------------
----|=======|------------------------------------------------------------------------------|========|-------------------
----|&....X.|------------------------------------------------------------------------------|........|-------------------
----|..T..O.|------------------------------------------------------------------------------|..B.O.T.|-------------------
----|.......|------------------------------------------------------------------------------|....B...|-------------------
----|.A.L...|------------------------------------------------------------------------------|....TT..|-------------------
----|......./#########---------------------------------------------------------------------|......O.|-------------------
----|Q......|--------#---------------------------------------------------------------------|..Q.....|-------------------
----|=======|--------#---------------------------------------------------------------------|.G>UG.TG|-------------------
---------------------#---------------------------------------------------------------------|.G.G....|-------------------
------------------|==+====|----------------------------------------------------------------|======+=|-------------------
------------------|.....EC|-------------------------------------------------|=========|-----------#---------------------
------------------|...H...|-------------------------------------------------|.........|-----------#---------------------
------------------|....N..|-------------------------------------------------|...ZG....+############---------------------
------------------|.T.....|-------------------------------------------------|ZV.......|---------------------------------
------------------|.H.....|-------------------------------------------------|..G..OC.C|---------------------------------
------------------|=====+=|-------------------------------------------------|E.......Z|---------------------------------
------------------------#---------------------------------------------------|===+=====|---------------------------------
------------------------#-------------------------------------------------------#---------------------------------------
------------------------#-----------------------------------|======|------------#---------------------------------------
------------------------#-----------|======|----------------|......|------------#---------------------------------------
------------------------#-----------|......|----------------|...N..|------------#---------------------------------------
------------------------#-----------|..Q...|----------------|.C*T..|------------#---------------------------------------
------------------------############+.S.EQ.@################+......|------------#---------------------------------------
------------------------------------|..A...|----------------|......|------------#---------------------------------------
------------------------------------|....V.|----------------|....D.|------------#---------------------------------------
------------------------------------|...F..|----------------|.O..../#############---------------------------------------
------------------------------------|....W.|----------------|....F.|----------------------------------------------------
------------------------------------|======|----------------|======|----------------------------------------------------
------------------------------------------------------------------------------------------------------------------------
