------------------------------------------------------------------------------------------------------------------------
-----|========|---------------------------------------------------------------------------------------------------------
-----|........|---------------------------------------------------------------------------------------------------------
-----|..T.....+################################-------------------------------------------------------------------------
-----|S..O...F|-------------------------------#-------------------------------------------------------------------------
-----|....<...|-------------------------------#---------------------------------------|=========|-----------------------
-----|........|-------------------------------#---------------------------------------|.>.......|-----------------------
-----|===+====|-------------------------------#---------------------------------------|GT.T.....|-----------------------
---------##########-----------------------|===+====|----------------------------------|......G..|-----------------------
------------------#-----------------------|........|----------------------------------|.........|-----------------------
------------------#-----------------------|....C...|----------------##################+..T.O....|-----------------------
------------------#-----------------------|....T...|----------------#-----------------|....F....|-----------------------
------------|=====+==|--------------------|......D.+#################-----------------|.........|-----------------------
------------|........|--------------------|......O.|----------------------------------|..O.T.B..|-----------------------
------------|........|--------------------|........|----------------------------------|.........|-----------------------
------------|..HZ.FO.|--------------------|===_====|----------------------------------|=========|-----------------------
------------|......T.|------------------------#-------------------------------------------------------------------------
------------|........|------------------------#-------------------------------------------------------------------------
------------|........|------------------------#-------------------------------------------------------------------------
------------|=+======|------------------------#-------------------------------------------------------------------------
--------------#-------------------------------#----------|======|-------------------------------------------------------
--------------#------------|========|---------#----------|.....C|-------------------------------------------------------
--------------#------------|....M...|---------###########+......|-------------------------------------------------------
--------------#############+.F....S.|--------------------|.GCO..|-------------------------------------------------------
---------------------------|.F......|--------------------|G.....|-------------------------------------------------------
---------------------------|========|--------------------|F..*..|-------------------------------------------------------
---------------------------------------------------------|======|-------------------------------------------------------
------------------------------------------------------------------------------------------------------------------------
------------------------------------------------------------------------------------------------------------------------
------------------------------------------------------------------------------------------------------------------------
