------------------------------------------------------------------------------------------------------------------------
----|========|----------------------------------------------------------------------------|======|----------------------
----|........|----------------------------------------------------------------------------|*.....|----------------------
----|........+#########-------------------------------------------------------------------|...T.B|----------------------
----|.OK...EA|--------#-------------------------------------------------------------------|...TB.|----------------------
----|....T...|--------#-------------------------------------------------------------------|.O....|----------------------
----|..<.....|--------#-------------------------------------------------------------------|..GT.F|----------------------
----|========|--------#-------------------------------------------------------------------|.GU...|----------------------
----------------------#-------------------------------------------------------------------|...GT.|----------------------
----------------------#-------------------------------------------------------------------|.>....|----------------------
----------------------#-----------------------------------------------------|======|------|===+==|----------------------
------------------|===+=|---------------------------------------------------|.H....|----------#-------------------------
------------------|.....|---------------------------------------------------|..ZZ..+###########-------------------------
------------------|...O.|---------------------------------------------------|G.....|------------------------------------
------------------|..T..|---------------------------------------------------|..C...|------------------------------------
------------------|...ZZ|---------------------------------------------------|.GO...|------------------------------------
------------------|.K...|---------------------------------------------------|..C...|------------------------------------
------------------|H....|---------------------------------------------------|=+====|------------------------------------
------------------|.....|-----------------------------------------------------#-----------------------------------------
------------------|===+=|-----------------------------------|=====|-----------#-----------------------------------------
----------------------#---------------|======|--------------|..W..|-----------#-----------------------------------------
----------------------#---------------|......|--------------|.V...|-----------#-----------------------------------------
----------------------################+....SE|--------------|.....|-----------#-----------------------------------------
--------------------------------------|S.....|--------------|...Z.|-----------#-----------------------------------------
--------------------------------------|.S....+##############+.O.../############-----------------------------------------
--------------------------------------|.U....|--------------|.....|-----------------------------------------------------
--------------------------------------|Q.Q...|--------------|=====|-----------------------------------------------------
--------------------------------------|......|--------------------------------------------------------------------------
--------------------------------------|======|--------------------------------------------------------------------------
------------------------------------------------------------------------------------------------------------------------
