------------------------------------------------------------------------------------------------------------------------
------------------------------------------------------------------------------------------------------------------------
-------|========|-------------------------------------------------------------------------------------------------------
-------|&.......|-------------------------------------------------------------------|==========|------------------------
-------|........+#################################----------------------------------|..........|------------------------
-------|.....O..|--------------------------------#----------------------------------|......^...|------------------------
-------|........|--------------------------------#----------------------------------|..........|------------------------
-------|....^...|----------------------------|===+=======|--------------------------|..........|------------------------
-------|........|----------------------------|...........|--------------------------|........O.|------------------------
-------|======+=|----------------------------|...........|--------------------------|..........|------------------------
--------------#####--------------------------|...........|--------------------------|..T.......|------------------------
------------------#--------------------------|...........|------------##############+..........|------------------------
------------------#--------------------------|..O......^.+#############-------------|...>......|------------------------
------------------#--------------------------|...........|--------------------------|...T......|------------------------
------------------#--------------------------|====_======|--------------------------|..........|------------------------
------------|=====+===|---------------------------#---------------------------------|...O......|------------------------
------------|.........|---------------------------#---------------------------------|..........|------------------------
------------|.....O...|----|=====|----------------#---------------------------------|..........|------------------------
------------|.........|----|.....|----------------#---------------------------------|..........|------------------------
------------|.........|----|.....|----------------#------------|====|---------------|..........|------------------------
------------|.........|----|.....|----------------#------------|...G|---------------|..........|------------------------
------------|======+==|----|.....|----------------#------------|.Z..|---------------|==========|------------------------
-------------------#-------|.....|----------------#------------|ZH.G|---------------------------------------------------
-------------------#-------|.....|----------------#############+..Z.|---------------------------------------------------
-------------------#-------|.....|-----------------------------|Q...|---------------------------------------------------
-------------------########+.....|-----------------------------|====|---------------------------------------------------
---------------------------|.....|--------------------------------------------------------------------------------------
---------------------------|=====|--------------------------------------------------------------------------------------
------------------------------------------------------------------------------------------------------------------------
------------------------------------------------------------------------------------------------------------------------
