------------------------------------------------------------------------------------------------------------------------
----------------------------------------------------------------------------------------------|=======|-----------------
-----|========|-------------------------------------------------------------------------------|.......|-----------------
-----|...E....|-------------------------------------------------------------------------------|G...T..|-----------------
-----|..<..T..|-------------------------------------------------------------------------------|...T...|-----------------
-----|...L.O..+######-------------------------------------------------------------------------|....TO.|-----------------
-----|......S.|-----#-------------------------------------------------------------------------|.......|-----------------
-----|========|-----#-------------------------------------------------------------------------|.OGF...|-----------------
--------------------#-------------------------------------------------------------------------|.T>..U.|-----------------
--------------------#-------------------------------------------------------------------------|G.BGB..|-----------------
----------------|===+==|---------------------------------------------------|=====|------------|==+====|-----------------
----------------|......|---------------------------------------------------|.....|---------------#----------------------
----------------|..T...|---------------------------------------------------|....Z+################----------------------
----------------|.*.N..|---------------------------------------------------|GKQ..|--------------------------------------
----------------|...OC.|---------------------------------------------------|..C..|--------------------------------------
----------------|.E....|---------------------------------------------------|...G.|--------------------------------------
----------------|.Z...C|---------------------------------------------------|....C|--------------------------------------
----------------|====+=|---------------------------------------------------|Z....|--------------------------------------
---------------------#-----------------------------------------------------|=+===|--------------------------------------
---------------------#-----------------------------------|========|----------#------------------------------------------
---------------------#--------------|=======|------------|...HQ...|----------#------------------------------------------
---------------------#--------------|.E...A.|------------|........|----------#------------------------------------------
---------------------#--------------|.......|------------|........|----------#------------------------------------------
---------------------#--------------|......W|------------|........|----------#------------------------------------------
---------------------#--------------|.E.....|------------|...T....|----------#------------------------------------------
---------------------###############+Q......+############+S....L..+###########------------------------------------------
------------------------------------|F......|------------|..O.....|-----------------------------------------------------
------------------------------------|..S....|------------|........|-----------------------------------------------------
------------------------------------|.......|------------|========|-----------------------------------------------------
------------------------------------|=======|---------------------------------------------------------------------------
