------------------------------------------------------------------------------------------------------------------------
------------------------------------------------------------------------------------------------------------------------
-------|=========|------------------------------------------------------------------------------------------------------
-------|&........|------------------------------------------------------------------------------------------------------
-------|...TO....|------------------------------------------------------------------------------------------------------
-------|.......*./#######################################---------------------------------------------------------------
-------|.........|--------------------------------------#---------------------------------------------------------------
-------|.X...F...|--------------------------------------#----------------------------|===========|----------------------
-------|.....D...|--------------------------------------#----------------------------|...........|----------------------
-------|=@=======|-----------------------------|========+==|-------------------------|...........|----------------------
---------#########-----------------------------|...W.......|------------#############+..GT...O...|----------------------
-----------------#-----------------------------|....O......|------------#------------|...........|----------------------
-----------------#-----------------------------|......FH...@#############------------|...........|----------------------
-----------------#-----------------------------|.........T.|-------------------------|.....T.....|----------------------
------------|====+==|--------------------------|...........|-------------------------|..T........|----------------------
------------|F......|--------------------------|=========+=|-------------------------|...........|----------------------
------------|..C....|------------------------------------#---------------------------|.G....>.B..|----------------------
------------|.O..TZ.|------------------------------------#---------------------------|...T.......|----------------------
------------|.......|------------------------------------#---------------------------|....F......|----------------------
------------|...C...|------------------------------------#---------------------------|===========|----------------------
------------|=+=====|------------------------------------#--------------------------------------------------------------
--------------#---------------|=======|------------------#|=========|---------------------------------------------------
--------------#---------------|......F|------------------#|.F....G..|---------------------------------------------------
--------------################+.F.....|------------------#+.HO......|---------------------------------------------------
------------------------------|....AD.|-------------------|.C.......|---------------------------------------------------
------------------------------|=======|-------------------|.........|---------------------------------------------------
----------------------------------------------------------|........G|---------------------------------------------------
----------------------------------------------------------|=========|---------------------------------------------------
------------------------------------------------------------------------------------------------------------------------
------------------------------------------------------------------------------------------------------------------------
