------------------------------------------------------------------------------------------------------------------------
------------------------------------------------------------------------------------------------------------------------
-----|========|---------------------------------------------------------------------------------------------------------
-----|&.......|---------------------------------------------------------------------------------------------------------
-----|........|---------------------------------------------------------------------------------------------------------
-----|......../##################################-----------------------------------------------------------------------
-----|...S.O..|---------------------------------#-----------------------------------------------------------------------
-----|.T....<.|---------------------------------#-----------------------------------------------------------------------
-----|........|---------------------------------#-----------------------------------------------------------------------
-----|==+=====|---------------------------|=====+=|---------------------------------|=======|---------------------------
--------###########-----------------------|.......|---------------------------------|.......|---------------------------
------------------#-----------------------|.T.....|----------------#################+.......|---------------------------
--------------|===@===|-------------------|.......|----------------#----------------|..T....|---------------------------
--------------|*......|-------------------|.......|----------------#----------------|.BG....|---------------------------
--------------|C......|-------------------|......H|----------------#----------------|..T....|---------------------------
--------------|..FT...|-------------------|.......@#################----------------|.>.FO..|---------------------------
--------------|.H.C...|-------------------|.D.....|---------------------------------|G......|---------------------------
--------------|.......|-------------------|...F.O.|---------------------------------|=======|---------------------------
--------------|=+=====|-------------------|.......|---------------------------------------------------------------------
----------------#-------------------------|====+==|---------------------------------------------------------------------
----------------#------------------------------#------------------------------------------------------------------------
----------------#-------------|======|---------#-------------|====|-----------------------------------------------------
----------------#-------------|W...F.|---------#-------------|.G..|-----------------------------------------------------
----------------##############+...F..|---------#-------------|H..Z|-----------------------------------------------------
------------------------------|..A...|---------##############+...F|-----------------------------------------------------
------------------------------|======|-----------------------|G.O.|-----------------------------------------------------
-------------------------------------------------------------|....|-----------------------------------------------------
-------------------------------------------------------------|====|-----------------------------------------------------
------------------------------------------------------------------------------------------------------------------------
------------------------------------------------------------------------------------------------------------------------
