------------------------------------------------------------------------------------------------------------------------
-------|======|---------------------------------------------------------------------------------------------------------
-------|&.....|---------------------------------------------------------------------------------------------------------
-------|......+##############################---------------------------------------------------------------------------
-------|....O.|-----------------------------#---------------------------------------------------------------------------
-------|X.ST..|-----------------------------#---------------------------------------------------------------------------
-------|..F...|-----------------------------#------------------------------------------|==========|---------------------
-------|=@====|-----------------------------#------------------------------------------|........>.|---------------------
---------#############----------------------#------------------------------------------|...BG.....|---------------------
---------------------#----------------------#------------------------------------------|..........|---------------------
---------------------#--------------------|=+====|-------------------------------------|G...T.....|---------------------
---------------------#--------------------|......|-------------------------------------|..........|---------------------
---------------------#--------------------|......|-------------------------------------|..........|---------------------
---------------------#--------------------|......|------------------###################+..........|---------------------
--------------|======+==|-----------------|...O..|------------------#------------------|.....T....|---------------------
--------------|...F.....|-----------------|......|------------------#------------------|...O......|---------------------
--------------|.....T.H.|-----------------|..T...|------------------#------------------|.....T....|---------------------
--------------|.........|-----------------|.DH...@###################------------------|....F.....|---------------------
--------------|...C...O.|-----------------|......|-------------------------------------|..........|---------------------
--------------|.......H.|-----------------|.F....|-------------------------------------|==========|---------------------
--------------|=======+=|-----------------|====+=|----------------------------------------------------------------------
----------------------#------------------------#------------------------------------------------------------------------
----------------------#----|=========|---------#--------|======|--------------------------------------------------------
----------------------#----|.........|---------#--------|....G.|--------------------------------------------------------
----------------------#----|.........|---------#--------|.....Z|--------------------------------------------------------
----------------------#####+........W|---------#########+H.G.O.|--------------------------------------------------------
---------------------------|....M.F*.|------------------|......|--------------------------------------------------------
---------------------------|=========|------------------|======|--------------------------------------------------------
------------------------------------------------------------------------------------------------------------------------
------------------------------------------------------------------------------------------------------------------------
