------------------------------------------------------------------------------------------------------------------------
-------|=======|--------------------------------------------------------------------------------------------------------
-------|&......|--------------------------------------------------------------------------------------------------------
-------|.......+###############################-------------------------------------------------------------------------
-------|...TX..|------------------------------#-------------------------------------------------------------------------
-------|.W.....|------------------------------#-------------------------------------------------------------------------
-------|.......|------------------------------#-------------------------------------------------------------------------
-------|..OF...|------------------------------#----------------------------------|===========|--------------------------
-------|.......|------------------------------#----------------------------------|.....G.....|--------------------------
-------|==@====|--------------------------|===+=======|------------##############+....T......|--------------------------
----------########------------------------|...........|------------#-------------|..OT....T..|--------------------------
-----------------#------------------------|...........|------------#-------------|....T.F...B|--------------------------
-----------------#------------------------|........T..|------------#-------------|G..*...>...|--------------------------
------------|====+====|-------------------|...........|------------#-------------|===========|--------------------------
------------|....Z....|-------------------|..DF.......|------------#----------------------------------------------------
------------|.........|-------------------|.....C.O...@#############----------------------------------------------------
------------|......C..|-------------------|...........|-----------------------------------------------------------------
------------|.........|-------------------|=======+===|-----------------------------------------------------------------
------------|...F.....|---------------------------#---------------------------------------------------------------------
------------|C..TO....|---------------------------#---------------------------------------------------------------------
------------|.........|---------------------------#----|====|-----------------------------------------------------------
------------|======+==|------|=======|------------#----|....|-----------------------------------------------------------
-------------------#---------|.F.....|------------#####+..C.|-----------------------------------------------------------
-------------------##########+..S....|-----------------|CFOG|-----------------------------------------------------------
-----------------------------|F..S...|-----------------|....|-----------------------------------------------------------
-----------------------------|=======|-----------------|====|-----------------------------------------------------------
------------------------------------------------------------------------------------------------------------------------
------------------------------------------------------------------------------------------------------------------------
------------------------------------------------------------------------------------------------------------------------
------------------------------------------------------------------------------------------------------------------------
