------------------------------------------------------------------------------------------------------------------------
---------------------------------------------------------------------------------------------|=====|--------------------
--|=====|------------------------------------------------------------------------------------|.G...|--------------------
--|&....|------------------------------------------------------------------------------------|.U.B.|--------------------
--|.T.N.|------------------------------------------------------------------------------------|Q.TO.|--------------------
--|A..OQ/##################------------------------------------------------------------------|>..T.|--------------------
--|....<|-----------------#------------------------------------------------------------------|.GT..|--------------------
--|=====|-----------------#------------------------------------------------------------------|.....|--------------------
--------------------------#------------------------------------------------------------------|..G.B|--------------------
--------------------------#------------------------------------------------------------------|...G.|--------------------
--------------------|=====+=|-----------------------------------------------|=======|--------|===+=|--------------------
--------------------|......F|-----------------------------------------------|H.....H|------------#----------------------
--------------------|.U..Z..|-----------------------------------------------|.G.....|------------#----------------------
--------------------|......C|-----------------------------------------------|......C|------------#----------------------
--------------------|.T.O...|-----------------------------------------------|..H....|------------#----------------------
--------------------|.....Z.|-----------------------------------------------|..G..K.|------------#----------------------
--------------------|.......|-----------------------------------------------|.....O.+#############----------------------
--------------------|=====@=|-----------------------------------------------|C......|-----------------------------------
--------------------------#-------------------------------------------------|==+====|-----------------------------------
--------------------------#----------------------------|======|----------------#----------------------------------------
--------------------------#---------|=========|--------|......|----------------#----------------------------------------
--------------------------#---------|.A.....WF|--------|...O../#################----------------------------------------
--------------------------#---------|.D...*...|--------|.NT..H|---------------------------------------------------------
--------------------------##########+.......NQ+########+......|---------------------------------------------------------
------------------------------------|.....F..Q|--------|......|---------------------------------------------------------
------------------------------------|.........|--------|.F....|---------------------------------------------------------
------------------------------------|=========|--------|......|---------------------------------------------------------
-------------------------------------------------------|======|---------------------------------------------------------
------------------------------------------------------------------------------------------------------------------------
------------------------------------------------------------------------------------------------------------------------
