------------------------------------------------------------------------------------------------------------------------
--------------------------------------------|=========|-----------------------------------------------------------------
--------------------------------------------|.....C...|------------|==========|-----------------------------------------
--------------------------------------------|..O......|------------|..........|-----------------------------------------
--------------------------------------------|..E......|------------|..........|-----------------------------------------
--------------------------------------------|.....L...|------------|....O.....+######-----------------------------------
--------------------------------------------|....H....|------------|..........|-----#-----|========|--------------------
--------------------------------------------|H........|------------|..........|-----#-----|........|--------------------
--------------------------------------------|==+======|------------|..........|-----#-----|........|--------------------
-----------------------------------------------#-------------------|..........|-----#-----|...>....|--------------------
-----------------------------------------------#-------------------|..........|-----#-----|......O.|--------------------
-----------------------------------------------#-------------------|======+===|-----#-----|........|--------------------
-----------------------------------------------#--------------------------#---------######+........|--------------------
-----------------------------------------------#--------------------------#---------------|....O...|--------------------
-----------------------------------------------#------------|=======|-----#---------------|........|--------------------
-----------------------------------------------#------------|.<.....|-----#---------------|.^......|--------------------
-----------------------------------------------#------------|...^...+######---------------|........|--------------------
---|==============|----------------------------#------------|.......|---------------------|........|--------------------
---|..........A...|----------------------------#############+.......|---------------------|........|--------------------
---|...C......T...+###########------------------------------|.......|---------------------|========|--------------------
---|.....VO.......|----------#-----------|=========|--------|.......|---------------------------------------------------
---|.........Q....|----------#-----------|D...F.E*.|--------|.......|---------------------------------------------------
---|..............|----------#-----------|.........|--------|.......|---------------------------------------------------
---|==============|----------#-----------|.........|--------|.......|---------------------------------------------------
-----------------------------############/.A...E...|--------|==+====|---------------------------------------------------
-----------------------------------------|....A....+############--------------------------------------------------------
-----------------------------------------|=========|--------------------------------------------------------------------
------------------------------------------------------------------------------------------------------------------------
------------------------------------------------------------------------------------------------------------------------
------------------------------------------------------------------------------------------------------------------------
