------------------------------------------------------------------------------------------------------------------------
-----------|========|---------------------------------------------------------------------------------------------------
-----------|........|---------------------------------------------------------------------------------------------------
-----------|.<......+##############################################################################---------------------
-----------|.....O..|-----------------------------------------------------------------------------#---------------------
-----------|..T.....|-----------------------------------------------------------------------------#---------------------
-----------|====+===|-----------------------------------------------------------------------------#---------------------
----------------#----------------------------------------|========|-------------------------------#---------------------
----------------#----------------------------------------|........|-------------------------------#---------------------
----------------#----------------------------------------|........|---------------------------|===+====|----------------
----------------######-----------------------------------|........+######################-----|........|----------------
---------------------#-----------------------------------|........|---------------------######+...O....|----------------
---------------------#-----------------------------------|=====+==|---------------------------|........|----------------
-----------------|===+====|------------------------------------#------------------------------|........|----------------
-----------------|........|------------------------------------#------------------------------|........|----------------
-----------------|........|------------------------------------########-----------------------|...O....|----------------
-----------------|..O.....|-------------------------------------------#-----------------------|.....>..|----------------
-----------------|........|-------------------------------------------#-----------------------|========|----------------
-----------------|======+=|-------------------------------------------#-------------------------------------------------
------------------------#------------------------------------------|==+=====|-------------------------------------------
------------------------#------------------------------------------|........|-------------------------------------------
------------------------################---------------------------|........|-------------------------------------------
---------------------------------------#---------------------------|....O...|-------------------------------------------
-----------------------------------|===+====|----------------------|........|-------------------------------------------
-----------------------------------|........|----------------------|====+===|-------------------------------------------
-----------------------------------|.....O..|---------------------------#-----------------------------------------------
-----------------------------------|........+############################-----------------------------------------------
-----------------------------------|..T.....|---------------------------------------------------------------------------
-----------------------------------|========|---------------------------------------------------------------------------
------------------------------------------------------------------------------------------------------------------------
